Ben elma yemeyi seviyorum .	PRON NOUN VERB VERB PUNCT
Bu elbise çok hoşuma gitti .	DET NOUN ADV NOUN VERB PUNCT
Birlikte vakit geçirmek çok zevkli .	ADP NOUN VERB ADV ADJ PUNCT
Bakkalda ki karpuzu çok sevdim .	NOUN ADP NOUN ADV VERB PUNCT
Bu elma aşırı iyi .	DET NOUN ADJ ADJ PUNCT
Dün kü konser çok zevkli ydi .	NOUN ADP NOUN ADV ADJ AUX PUNCT
Zaman güzel geçiyor .	NOUN ADJ VERB PUNCT
Senin gelmen beni sevindirdi .	PRON VERB PRON VERB PUNCT
Pazarda ki şeftaliler çok güzel .	NOUN ADP NOUN ADV ADJ PUNCT
Dün gece çok güzeldi .	NOUN NOUN ADV VERB PUNCT
Kıyafetin çok havalı ymış .	NOUN ADV ADJ AUX PUNCT
Beni de çağırmana mutlu oldum .	PRON CCONJ VERB ADJ VERB PUNCT
Bugün kü koşu iyi geldi .	NOUN ADP NOUN ADJ VERB PUNCT
Yediğim tatlı cok güzeldi .	VERB ADJ ADV VERB PUNCT
Ben bu tada bayılıyorum .	PRON DET NOUN VERB PUNCT
Etkinlikte ki içecekleri aşırı sevdim .	NOUN ADP VERB ADJ VERB PUNCT
Bizim orada çok güzel ağaçlar var .	PRON NOUN ADV ADJ NOUN ADJ PUNCT
Bu maçı 12 . sınıflar kazandı .	DET NOUN NUM PUNCT NOUN VERB PUNCT
Bizimkiler de geliyor .	NOUN CCONJ VERB PUNCT
Şükürler olsun , onlar gelmiyor .	NOUN VERB PUNCT PRON VERB PUNCT
Şanslıyız , 12 . sınıflar kaybetti .	VERB PUNCT NUM ADJ NOUN VERB PUNCT
Neden gelmemesi heyecan ver ici ?	PRON VERB NOUN VERB ADP PUNCT
Bizimkiler de iyice heyecanlandı .	NOUN CCONJ ADV VERB PUNCT
Sen çok mutlu görünüyorsun .	PRON ADV ADJ VERB PUNCT
Evet , ben de geliyorum .	NOUN PUNCT PRON CCONJ VERB PUNCT
Anlatabilmek imkansız .	VERB ADJ PUNCT
Bizimkiler de iyice sinirlendi .	NOUN CCONJ ADV VERB PUNCT
Sen de amma mutlusun .	PRON CCONJ ADV VERB PUNCT
Evet , o pozisyon hakkı ydı ( ! )	NOUN PUNCT DET NOUN NOUN AUX PUNCT PUNCT PUNCT
Bu elbise güzel değil .	DET NOUN ADJ AUX PUNCT
Tezgahta yeterince eşya yok tu .	NOUN ADV NOUN ADV AUX PUNCT
Yedikleri incirleri beğenmediler .	VERB NOUN VERB PUNCT
İzleyiciler tiyatroyu beğenmedi .	NOUN NOUN VERB PUNCT
Bunun tadını sevmedim .	PRON NOUN VERB PUNCT
Şefta li ekşi değildi .	NOUN ADP ADJ AUX PUNCT
Sen bizimle gelmiyorsun .	PRON PRON VERB PUNCT
Dün kü oyun eğlence li değildi .	NOUN ADP NOUN NOUN ADP AUX PUNCT
Evet , seni hiç sevmedim .	NOUN PUNCT PRON ADV VERB PUNCT
Armutlar hiç kırmızı değil .	NOUN ADV ADJ AUX PUNCT
Hiç hoş değil .	ADV ADJ AUX PUNCT
Birlikte vakit geçirmek hiç zevkli değil .	ADP NOUN VERB ADV ADJ AUX PUNCT
Öğretmen derse gelmedi .	NOUN NOUN VERB PUNCT
Bunu sana vermek istemiyorum .	PRON PRON VERB VERB PUNCT
Bizimle gelemezsin .	PRON VERB PUNCT
Hayır , beğenmedim .	NOUN PUNCT VERB PUNCT
Hayır , maçı 12 . sınıflar kazandı .	ADP PUNCT NOUN NUM PUNCT NOUN VERB PUNCT
Tatlının tadını beğenmedim .	NOUN NOUN VERB PUNCT
Hayır , gelemezsin .	NOUN PUNCT VERB PUNCT
Bununla uğraşamam .	PRON VERB PUNCT
Senin gelmeni istemiyorum .	PRON VERB VERB PUNCT
İlkokul gösterime işlerinden izin alamadıkları için ne annem ne de babam gelebildi .	NOUN NOUN NOUN NOUN VERB ADP CCONJ NOUN CCONJ CCONJ NOUN VERB PUNCT
Bizim sınıfta diğer okulda bulunan bütün sınıflara göre hiç kız öğrenci yok .	PRON NOUN ADJ NOUN VERB ADJ NOUN ADP ADV ADJ NOUN ADJ PUNCT
Bana sorarsan bu kitapta ki bütün problemleri öğretmenler dahi çözemez .	PRON VERB DET NOUN ADP ADJ NOUN NOUN ADJ VERB PUNCT
Bugün gördüğüm kadarıyla ve hava durumuna baktığım kadarıyla hiç güzel bir gün değil .	NOUN VERB NOUN CCONJ NOUN NOUN VERB NOUN ADV ADJ DET NOUN AUX PUNCT
Dedem küçüklüğünden beri misafir olduğu evde fazla uyumayı hiç sevmez .	NOUN NOUN ADP NOUN VERB NOUN ADV VERB ADV VERB PUNCT
Bunca saat boyunca bütün işittiğin bu sözlerden sonra , uyu uyuyabilirsen !	ADJ NOUN ADP ADJ VERB DET NOUN ADP PUNCT VERB VERB PUNCT
Bu sınav için gerçekten bir ay boyunca çok çalıştım ama bugün sınavda başarısız oldum .	DET NOUN ADP ADV DET NOUN ADP ADV VERB CCONJ NOUN NOUN ADJ VERB PUNCT
Görünüşüne aldanıp pazardan satın aldığım ayvalar ne kadar da lezzet siz .	NOUN VERB NOUN ADV VERB NOUN PRON ADP CCONJ NOUN ADP PUNCT
Akşam gelecek olan misafirler için hazırladıkları bütün ikram edilecek yemekler tutsuz çıkmış .	NOUN VERB VERB NOUN ADP VERB ADJ NOUN VERB NOUN ADJ VERB PUNCT
Yarın benim yanıma , söylediğim yere çok daha erken bir saatte gelmemelisin .	NOUN PRON ADJ PUNCT VERB NOUN ADV ADV ADV DET NOUN VERB PUNCT
Hiçbir şekilde benden habersiz kimse kapıdan bir adım atıp dışarı çıkamaz .	DET NOUN PRON ADJ NOUN NOUN DET NOUN VERB NOUN VERB PUNCT
Nedense ben kitap okumayı çocukluğumdan beri oldum olası hiç sevmiyorum .	ADV PRON NOUN VERB NOUN ADP VERB ADJ ADV VERB PUNCT
Bursa ! daki yol çalışması yüzünden trafik tıkandığından dolayı vaktinde düğüne yetişemeyecekmiş .	PROPN PUNCT NOUN NOUN VERB NOUN NOUN VERB ADP NOUN NOUN VERB PUNCT
Dolaba kalkıp baktığımda evde içilebilecek bir tane bile içecek yok tu .	NOUN VERB VERB NOUN VERB DET NOUN ADV NOUN ADV AUX PUNCT
Sen gel de kola ysa bu kadar fazla işin içinden çık bakalım !	PRON VERB CCONJ NOUN AUX PRON ADP ADJ NOUN ADJ VERB VERB PUNCT
Beş yıldızlı bir restorandan tatlı sipariş ettim fakat burda ki tatlıların hepsi şekersizmiş .	NUM ADJ DET NOUN ADJ NOUN VERB CCONJ NOUN ADP NOUN PRON VERB PUNCT
Bu tarz bir firmanın böyle güzel hikayeli oyun yapıp bu kadar çirkin grafikler yapması beni üzdü .	DET ADJ DET NOUN ADV ADJ ADJ NOUN VERB DET ADP ADJ NOUN VERB PRON VERB PUNCT
İnsanların kendini üstün görmesinden , yalan söylemelerinden ve saçmasapan hareketlerinden nefret ediyorum .	NOUN PRON ADJ VERB PUNCT ADJ VERB CCONJ ADJ NOUN NOUN VERB PUNCT
Konuklarımız ne yaptığımız güzel yemekleri yedi ne el yapımı içeceklerimizden içti .	NOUN PRON VERB ADJ NOUN VERB PRON NOUN NOUN NOUN VERB PUNCT
Sanki bu bütün bu yaşanılmış olan olayların hepsinin sorumlusu benim !	ADV DET ADJ DET VERB VERB NOUN PRON NOUN PRON PUNCT
Sokaklar bugün yapılacak 29 ekim için olan tören yüzünden oldukça kalabalıktı .	NOUN NOUN VERB NUM NOUN ADP VERB NOUN NOUN ADV VERB PUNCT
Kesinlikle dediğin bütün sözleri şuan tam anlamıyla gerçekleştirdin !	NOUN VERB ADJ NOUN NOUN ADJ NOUN VERB PUNCT
Sana dün yaptığı hareketlerin , söylediği bütün olayların , yaşadıklarının hepsi yalanmış .	PRON NOUN VERB NOUN PUNCT VERB ADJ NOUN PUNCT VERB PRON VERB PUNCT
Eğer yapmak istediğin şeyi iyice düşünmeyip güzel bir plana oturmazsan yapacağın işin sonu kötü sonuçlanır .	CCONJ VERB VERB NOUN ADV VERB ADJ DET NOUN VERB VERB NOUN ADJ ADJ VERB PUNCT
Açgözlülük yapıp işinde olsun özel hayatında olsun parasını savurduğu için yoksul duruma düştü .	NOUN VERB NOUN VERB ADJ NOUN VERB NOUN VERB ADP ADJ NOUN VERB PUNCT
Bunca yaşadığım , gördüğüm , duyduğum şeylerden sonra onu sevmeyecek değilim .	ADJ VERB PUNCT VERB PUNCT VERB NOUN ADP PRON VERB AUX PUNCT
Kendimde ki ve etrafımda ki olayları gün geçtikçe daha iyi anlamaya başlamıştım .	NOUN ADP CCONJ NOUN ADP NOUN NOUN VERB ADV ADJ VERB VERB PUNCT
Bütçeme uygun çok güzel yeni çıkmış bir cep telefonu arıyorum .	NOUN ADJ ADV ADJ ADJ VERB DET NOUN NOUN VERB PUNCT
Doğum günün için aldığım sarı kapaklı kitapta çok yararlı bilgiler mevcutmuş .	NOUN NOUN ADP VERB ADJ ADJ NOUN ADV ADJ NOUN VERB PUNCT
Kafamda senin bana söylediğin ve tavsiye ettiğin benzer düşünceler yok değil .	NOUN PRON PRON VERB CCONJ NOUN VERB VERB NOUN ADV AUX PUNCT
İnsanlara ve çevrende ki arkadaşlarına neden böyle davrandığını anlamıyor değilim .	NOUN CCONJ NOUN ADP NOUN PRON ADV VERB VERB AUX PUNCT
Bu yıl düzenlenen kitap fuarı her zaman kinden daha çok renkli ydi .	DET NOUN VERB NOUN NOUN DET NOUN ADP ADV ADV ADJ AUX PUNCT
Annen bana gelip benim için tatlı yaptığını söyleyince gerçekten çok sevindim .	NOUN PRON VERB PRON ADP ADJ VERB VERB ADV ADV VERB PUNCT
Hayatımda ki bütün insanlar arasında en değer verdiğim kişi annem dir .	NOUN ADP ADJ NOUN ADJ ADV NOUN VERB NOUN NOUN AUX PUNCT
Bu okuduğum kitapta insan psikolojisine katkıda bulunacak birçok bilgi var dır .	DET VERB NOUN NOUN NOUN NOUN VERB DET NOUN ADJ AUX PUNCT
Yenilenebilir enerji hakkında yaptığı resim jüriler ve insanlar tarafından çok beğenildi .	ADJ NOUN NOUN VERB NOUN NOUN CCONJ NOUN NOUN ADV VERB PUNCT
Öğretmenlerinin , çevrende ki kişilerin dediği gibi ve çok çalışırsan başarılı olursun .	NOUN PUNCT NOUN ADP NOUN VERB ADP CCONJ ADV VERB ADJ VERB PUNCT
Annem ve babam bu soğuk havada dondurma yememe izin veriyor .	NOUN CCONJ NOUN DET ADJ NOUN NOUN VERB NOUN VERB PUNCT
Yeni severek aldığım kıyafetim tam üzerime istediğim gibi oturdu .	ADJ ADJ VERB NOUN ADV NOUN VERB ADP VERB PUNCT
Mehmet , milletin söylediğinin aksine çok duyarlı ve sorumluluk sahibi bir öğrenci dir .	PROPN PUNCT NOUN VERB ADV ADV ADJ CCONJ NOUN NOUN DET NOUN AUX PUNCT
Annemin yemeklerine kıyasla eşimin yaptığı birçok yemek annemin kinden daha lezzet li .	NOUN NOUN ADV NOUN VERB DET NOUN NOUN ADP ADV NOUN ADP PUNCT
Gerekse iş yerinde gerekse özel hayatında sergilediği hareketlerden ötürü çok olumlu tepkiler aldı .	ADV NOUN NOUN VERB ADJ NOUN VERB NOUN ADP ADV ADJ NOUN VERB PUNCT
Üniversiteyi bitirmek için çok uğraşıp hazırladığı projesi göründüğüne göre kötü değil .	NOUN VERB ADP ADV VERB VERB NOUN VERB ADP ADJ AUX PUNCT
Tarkan ' ın bu yıl yurtdışında ki konserleri herkes tarafından büyük ses getirdi .	PROPN PUNCT PROPN DET NOUN NOUN ADP NOUN NOUN NOUN ADJ NOUN VERB PUNCT
Kafasında kurduğu ve planladığı yatırımını yaptığı işlerinde hepsinin meyvesini topluyor şimdi .	NOUN VERB CCONJ VERB NOUN VERB NOUN PRON NOUN VERB ADV PUNCT
Onca işinin gücünün arasında ailesini de bırakıp yanımıza gelerek bizi yüzüstü bırakmadın .	DET NOUN ADJ ADJ NOUN CCONJ VERB ADJ VERB PRON ADJ VERB PUNCT
Tonlarca profesyonel çalışan arasından en becerikli olan çalışan Ayşe çıktı .	ADV ADJ VERB ADJ ADV ADJ VERB VERB PROPN VERB PUNCT
Kim ne derse desin bu hayatta gördüğüm en temiz insan babam dır .	PRON PRON VERB VERB DET NOUN VERB ADV ADJ NOUN NOUN AUX PUNCT
Dün okuldan eve dönerken metroda gördüğü güzel kıza aşık olduğunu söyledi .	NOUN NOUN NOUN VERB NOUN VERB ADJ ADJ ADJ VERB VERB PUNCT
Yüzyıl lardır süren büyük toprak savaşları sonunda ateşkes antlaşmaları imzalanarak barışa erdi .	NOUN AUX VERB ADJ NOUN NOUN ADV NOUN NOUN VERB NOUN VERB PUNCT
Bugün gerçekten harika görünüyorsun .	NOUN ADV ADJ VERB PUNCT
Az önce toplantıda öne sürdüğün fikir müthiş !	ADV ADV NOUN ADJ VERB NOUN ADJ PUNCT
Üzgünüm , maalesef hasta tedaviye cevap veriyor .	VERB PUNCT ADV ADJ NOUN NOUN VERB PUNCT
Tebrik ederim , yeni işin hayırlı olsun .	NOUN VERB PUNCT ADJ NOUN ADJ VERB PUNCT
O her sabah sokak hayvanlarını besler , kendisi çok iyi kalpli birisi dir .	PRON DET NOUN NOUN NOUN VERB PUNCT PRON ADV ADJ ADJ PRON AUX PUNCT
Bu sene marmaristeydik , tatil hepimize iyi geldi .	DET NOUN VERB PUNCT NOUN NOUN ADJ VERB PUNCT
Hep beraber basketbol oynamayı çok seviyorum .	ADV ADV NOUN VERB ADV VERB PUNCT
Yemekler enfes olmuş .	NOUN ADJ VERB PUNCT
Yaptığın sürpriz beni çok mutlu etti .	VERB NOUN PRON ADV ADJ VERB PUNCT
Gözlerin çok güzel .	NOUN ADV ADJ PUNCT
Melek gibi bir insandı .	NOUN ADP DET VERB PUNCT
Filmin başrolü karakteri çok iyi canlandırmış .	NOUN NOUN NOUN ADJ ADJ VERB PUNCT
Çocuğunuz çok tatlı ymış .	NOUN ADV ADJ AUX PUNCT
Üstünde ki tişörtü beğendim .	ADJ ADP NOUN VERB PUNCT
Bu güzel gün için teşekkür ederim .	DET ADJ NOUN ADP NOUN VERB PUNCT
Hoşgeldin neşe getirdin .	VERB NOUN VERB PUNCT
Saçların güzel olmuş .	NOUN ADJ VERB PUNCT
Kedim dumanı bulunca mutluluktan ağladım .	NOUN NOUN VERB NOUN VERB PUNCT
Kış mevsimini seviyorum .	NOUN NOUN VERB PUNCT
Yaz mevsimi hoşuma gidiyor .	NOUN NOUN NOUN VERB PUNCT
Pozisyonu iyi değerlendirdi ve golü buldu .	NOUN ADJ VERB CCONJ NOUN VERB PUNCT
Teşekkür ederim çok işime yaradı .	NOUN VERB ADJ NOUN VERB PUNCT
Kıyafetin çok güzelmiş .	NOUN ADV VERB PUNCT
Ayakkabılarına bayıldım .	NOUN VERB PUNCT
Güzel iş çıkardınız çocuklar .	ADJ NOUN VERB NOUN PUNCT
Üzgünüm bu olması gerektiği gibi düzenli değil .	VERB DET VERB VERB ADP ADJ AUX PUNCT
Bu adam tam bir trafik canavarı !	DET NOUN ADV DET NOUN NOUN PUNCT
Ne kadar da cimri bir insanmışsın .	PRON ADP CCONJ ADJ DET VERB PUNCT
Hasta tedaviye cevap vermiyor .	NOUN NOUN NOUN VERB PUNCT
Bunu düşünmedim mi sanki , kendini çok mu zeki zannediyorsun ?	PRON VERB AUX ADV PUNCT PRON ADV AUX ADJ VERB PUNCT
Gerçekten iğrenç bir hayat .	ADV ADJ DET NOUN PUNCT
Tabi öyle düşünürler , adın çıkmış dokuza inmez sekize .	INTJ ADV VERB PUNCT NOUN VERB NOUN VERB NOUN PUNCT
Davranış biçimi hiç hoş değildi .	NOUN NOUN ADV ADJ AUX PUNCT
Bu durumda bile problem çıkarıyorsun .	DET NOUN ADV NOUN VERB PUNCT
Bu oyunu çok kötü oynuyorsun .	DET NOUN ADV ADJ VERB PUNCT
Kötülük içine işlemiş .	NOUN ADJ VERB PUNCT
Acilen yemeğini bitirmen gerek , geç kalman işleri daha beter hale sokabilir .	NOUN NOUN VERB VERB PUNCT VERB VERB NOUN ADV ADJ NOUN VERB PUNCT
Basketbol oynamayı sevmiyorum .	NOUN VERB VERB PUNCT
Sözleri adeta zehir etkisi yaratmıştı .	NOUN ADV NOUN NOUN VERB PUNCT
Sorduğun sorular çok saçma .	VERB NOUN ADV ADJ PUNCT
Hayır onları istemiyorum .	NOUN PRON VERB PUNCT
Maçta yaptığı çok çirkin bir hareketti .	NOUN VERB ADV ADJ DET VERB PUNCT
Seni sürüm sürüm süründüreceğim .	PRON NOUN NOUN VERB PUNCT
O adama güvenme , tam bir düzenbaz .	DET NOUN VERB PUNCT ADJ DET NOUN PUNCT
Cezalandırılmayı hakediyorsun .	VERB VERB PUNCT
Gördün mü iki yüzlüyü nasıl da bizi sattı ?	VERB AUX NUM NOUN ADV CCONJ PRON VERB PUNCT
Kıskançlığı onu yolun sonuna getirdi .	NOUN PRON NOUN ADJ VERB PUNCT
Öyle nefret dolu ydu ki gözünü kırpmadan onu öldürdü .	ADJ NOUN ADJ AUX CCONJ NOUN VERB PRON VERB PUNCT
Bu yıl kış mevsimi çok sert geçti , soğuğu sevmiyorum .	DET NOUN NOUN NOUN ADV ADJ VERB PUNCT NOUN VERB PUNCT
Yaz mevsimi çok sıcak olduğundan hoşuma gitmiyor .	NOUN NOUN ADV ADJ VERB NOUN VERB PUNCT
Bu sayfada paylaşılan oyun benim beklediğim kadar kötü çıkmadı .	DET NOUN VERB NOUN PRON VERB ADP ADJ VERB PUNCT
Okulun yeniden açılması umduğum kadar kötü olmadı .	NOUN ADV VERB VERB ADP ADJ VERB PUNCT
Bu maç geçen haftada ki maçtan sonra sandığımdan daha iyi geçti .	DET NOUN ADJ NOUN ADP NOUN ADP VERB ADV ADJ VERB PUNCT
Bu otel odasının içi sandığımdan daha soğukmuş .	DET NOUN NOUN ADJ VERB ADV VERB PUNCT
Hava sandığımdan daha güzeldi .	NOUN VERB ADV VERB PUNCT
Kahvenin tadı , görüntüsü gibi güzeldi .	NOUN NOUN PUNCT NOUN ADP VERB PUNCT
Bu markanın klavyesi sandığımdan da daha iyi çıktı .	DET NOUN NOUN VERB CCONJ ADV ADJ VERB PUNCT
Bilgisayarı güncellemek geçen ki sefere göre sandığımdan daha kısa sürdü .	NOUN VERB ADJ CCONJ NOUN ADP VERB ADV ADJ VERB PUNCT
Bu parfüm daha önce denediğim halinden daha kötü kokuyor .	DET NOUN ADV ADV VERB NOUN ADV ADJ VERB PUNCT
Soruları eskiden çözdüğüm gibi kolay bir şekilde çözemiyorum .	NOUN ADJ VERB ADP ADJ DET NOUN VERB PUNCT
Şu uygulamadan bulduğum videoyu soluksuz bir şekilde izledim .	DET NOUN VERB NOUN ADJ DET NOUN VERB PUNCT
Televizyonda izlediğim dizi umduğumdan daha da kötü çıktı .	NOUN VERB NOUN NOUN ADV CCONJ ADJ VERB PUNCT
Bilgisayarın içini temizlemek sandığımdan daha çabuk bitti .	NOUN ADJ VERB VERB ADV ADJ VERB PUNCT
Bu film önce ki serisinde olduğu gibi muhteşem bir başlangıç yaptı .	DET NOUN NOUN ADP NOUN VERB ADP ADJ DET NOUN VERB PUNCT
Taktığım kolye üstümde sandığımdan daha iyi ve güzel durdu .	VERB NOUN NOUN VERB ADV ADJ CCONJ ADJ VERB PUNCT
Bugüne kadar gördüğüm en abartılmış oyuncu olma yolunda ilerliyorsun .	NOUN ADP VERB ADV VERB NOUN VERB NOUN VERB PUNCT
Oynadığımız oyunda benim yüzümden son anda maçı kaybettik .	VERB NOUN PRON NOUN ADJ NOUN NOUN VERB PUNCT
Sabah uykumdan çok mutlu bir şekilde uyandım .	NOUN NOUN ADV ADJ DET NOUN VERB PUNCT
Bu kötü ortamda seninle bu güzel sohbeti yapmak beni çok rahatlatıyor .	DET ADJ NOUN PRON DET ADJ NOUN VERB PRON ADV VERB PUNCT
Bu güzel havada başıma böyle bir şeyin gelmesi beni çok rahatsız ediyor .	DET ADJ NOUN NOUN ADJ DET NOUN VERB PRON ADV ADJ VERB PUNCT
Senin yaptıkların yüzünden sevdiğim işleri yapamamaktan nefret ediyorum .	PRON VERB NOUN VERB NOUN VERB NOUN VERB PUNCT
Seni burada bu şekilde görmek onu sandığından daha çok üzüyor .	PRON NOUN DET NOUN VERB PRON VERB ADV ADV VERB PUNCT
Yarın gün benim için bugünden daha iyi olacak .	NOUN NOUN PRON ADP NOUN ADV ADJ VERB PUNCT
Onun bu anlamsız hareketleri beni sinirlendiriyor .	PRON DET ADJ NOUN PRON VERB PUNCT
Bu saçma sapan ödevi yaparken gereksiz yere çok zorlandım .	DET ADJ NOUN NOUN VERB ADJ NOUN ADV VERB PUNCT
Bu proje için bu sayfa düzeni pek içime sinmedi .	DET NOUN ADP DET NOUN NOUN ADV ADJ VERB PUNCT
Bu paragraflar daha önce ki gördüğüm paragraflardan daha uzun olamazdı !	DET NOUN ADV ADV ADP VERB NOUN ADV ADJ VERB PUNCT
Onun bu şartlar altında neler yapabileceğini tahmin bile etmek istemiyorum .	PRON DET NOUN ADJ PRON VERB NOUN ADV VERB VERB PUNCT
Bu ödevin önce ki yaptığımız ödevden daha iyi olacağını düşünüyorum .	DET NOUN NOUN ADP VERB NOUN ADV ADJ ADJ VERB PUNCT
Bu programlama dilini hiç sevmedim .	DET VERB NOUN ADV VERB PUNCT
İstediği şeker markette olmadığı için bütün gün mızmızlanarak ağladı .	VERB NOUN NOUN VERB ADP ADJ NOUN VERB VERB PUNCT
Bu kaldırım taşlarının bu kadar güzel olduğunu daha önce fark etmemiştim .	DET NOUN NOUN DET ADP ADJ VERB ADV ADV NOUN VERB PUNCT
Okula giderken defterimi kaybettiğim için bu dersin notlarını alamadım .	NOUN VERB NOUN VERB ADP DET NOUN NOUN VERB PUNCT
Onu bunca aradan sonra böyle gördüğüm için çok sevindim .	PRON ADJ ADJ ADP ADV VERB ADP ADV VERB PUNCT
Geceleri iyi bir uyku uyuyamamaktan nefret ediyorum .	NOUN ADJ DET NOUN VERB NOUN VERB PUNCT
Bu filmi seninle birlikte tekrar tekrar izlemeye bayılıyorum .	DET NOUN PRON ADP ADV ADV VERB VERB PUNCT
Bu yaşadığımız kötü durumdan dolayı sizi şikayet ediyorum .	DET VERB ADJ NOUN ADP PRON NOUN VERB PUNCT
Bu düşünce li davranışınızdan dolayı sizi takdir ediyorum .	DET NOUN ADP NOUN ADP PRON NOUN VERB PUNCT
Rezalet bir hizmet anlayışınız olduğu için sizi kınıyorum .	ADJ DET NOUN NOUN VERB ADP PRON VERB PUNCT
Ne yaparsan yap sizin bu kötü tutumunuzu göz ardı edemeyeceğiz .	PRON VERB VERB PRON DET ADJ NOUN NOUN NOUN VERB PUNCT
Böyle bir hikayenin sonu ancak bu kadar güzel bitebilirdi .	ADJ DET NOUN ADJ ADV PRON ADP ADJ VERB PUNCT
Uzun zaman dır beklediğimiz bu yarışma hüsran ile sonuçlandı .	ADJ NOUN ADP VERB DET NOUN NOUN CCONJ VERB PUNCT
Bu işin üstesinden gelebilecek kadar güçlü biri olduğumu biliyordum .	DET NOUN ADJ VERB ADP ADJ PRON VERB VERB PUNCT
Bu projede büyük ölçüde başarılı olacağımızı tahmin ediyorum .	DET NOUN ADJ NOUN ADJ VERB NOUN VERB PUNCT
Bir karar ancak bu kadar düşünmeden verilebilirdi .	DET NOUN ADV DET ADP VERB VERB PUNCT
Görüp görebileceğim en karmaşık filmlerden bir tanesini izlemiş bulunmakta yım .	VERB VERB ADV ADJ NOUN DET NOUN VERB VERB AUX PUNCT
Bu hoş patatesleri görünce yüzümde bir tebessüm oluştu .	DET ADJ NOUN VERB NOUN DET NOUN VERB PUNCT
Başımıza ne gelirse gelsin bu projeyi hep beraber yapacağız .	NOUN PRON VERB VERB DET NOUN ADV ADV VERB PUNCT
Malzeme kalitesi bu kadar berbat olan bir ürünü daha önce hiçbir yerde görmedim .	NOUN NOUN DET ADP ADJ VERB DET NOUN ADV ADV DET NOUN VERB PUNCT
Geri bildirim hızı , bu kadar hızlı olan bir site gördüğümü hatırlamıyorum .	ADJ NOUN NOUN PUNCT DET ADP ADJ VERB DET NOUN VERB VERB PUNCT
Kendimde ki ve etrafımda ki olayları gün geçtikçe daha iyi anlamaya başlamıştım .	NOUN ADP CCONJ NOUN ADP NOUN NOUN VERB ADV ADJ VERB VERB PUNCT
Bazıları müzik dinlemekten , bazıları da resim yapmaktan hoşlanır .	PRON NOUN VERB PUNCT PRON CCONJ NOUN VERB VERB PUNCT
Çok geniş görüş lü bir insan olması onun iş dünyasında ki başarısını açıklıyordu .	ADV ADJ NOUN ADP DET NOUN VERB PRON NOUN NOUN ADP NOUN VERB PUNCT
Arkamızda ki insanların bize destek olması gücümüze güç katıyordu .	ADJ ADP NOUN PRON NOUN VERB NOUN ADJ VERB PUNCT
Yapılan etkinlikte ki yüzlerce katılımcıyı görüp heyecanlanmamak elde değildi .	VERB NOUN ADP NUM NOUN VERB VERB NOUN AUX PUNCT
O kadar hoşgörülü bir insan ki herkesle çok iyi anlaşır .	PRON ADP ADJ DET NOUN CCONJ NOUN ADV ADJ VERB PUNCT
Müzeye taşınan elmasın öyle paha biçilemez bir güzelliği vardı ki değerini daha da iyi anladım .	NOUN VERB NOUN ADV NOUN VERB DET NOUN VERB CCONJ NOUN ADV CCONJ ADJ VERB PUNCT
Bana verdiği hediye manevi olarak çok değerli , hayatım boyunca unutamayacağım bir hediye ydi .	PRON VERB NOUN ADJ ADP ADV ADJ PUNCT NOUN ADP VERB DET NOUN AUX PUNCT
Katıldığı yarışmada çok başarılı bir performans göstererek ödüle layık görüldü .	VERB NOUN ADV ADJ DET NOUN VERB NOUN NOUN VERB PUNCT
Hayatı boyunca kimseyi kırmamıştı , çevresinde ki herkes onu çok severdi .	NOUN ADP NOUN VERB PUNCT NOUN ADP NOUN PRON ADV VERB PUNCT
Tüm derslerini başarıyla tamamlayarak takdir belgesi almaya hak kazandı .	DET NOUN NOUN VERB NOUN NOUN VERB NOUN VERB PUNCT
Babası hastayken umudunu hiç kaybetmeyerek babasının iyileşmesinde en büyük rolü o üstlendi .	NOUN ADV NOUN ADV VERB NOUN VERB ADV ADJ NOUN PRON VERB PUNCT
Yeni müdür , okula geldiği ilk günden herkesin dikkatini çekmişti .	ADJ NOUN PUNCT NOUN VERB ADJ NOUN NOUN NOUN VERB PUNCT
Dürüstlük onun için en önem li şeydi , kimseye yalan söylemezdi .	NOUN PRON ADP ADV NOUN ADP AUX PUNCT NOUN ADJ VERB PUNCT
Çok duygusal bir insan olduğu için söyleyeceklerimizi iki kere düşünür , onu kırmamaya dikkat ederdik .	ADV ADJ DET NOUN VERB ADP VERB NUM NOUN VERB PUNCT PRON VERB NOUN VERB PUNCT
İyi dostlar destek olur . En iyi dostlar ise hiçbir şey olmamış gibi davranır .	ADJ NOUN NOUN VERB PUNCT ADV ADJ ADJ AUX DET NOUN VERB ADP VERB PUNCT
Tatilden döndüğünde o kadar değişmişti ki resmen gençleşmişti .	NOUN VERB DET ADP VERB CCONJ ADV VERB PUNCT
Ailesi yarışmada dereceye girip ödül alan çocuklarıyla inanılmaz gururluydular .	NOUN NOUN NOUN VERB NOUN VERB NOUN VERB VERB PUNCT
Bu marka ürettiği ürünlerin kalitesini uluslararası çapta ispat etmişti .	DET NOUN VERB NOUN NOUN ADJ NOUN NOUN VERB PUNCT
İlk defa geldiğim bu lokantada yediğim yemek çok lezzetli ydi .	ADJ NOUN VERB DET NOUN VERB NOUN ADV ADJ AUX PUNCT
Merhamet li olmak ağlayanla ağlamak değildir . Ağlayanın gözyaşını dindirecek bir çözüm yolu bulmak ya bulmaya çalışmak tır .	NOUN ADP VERB NOUN VERB AUX PUNCT NOUN NOUN VERB DET NOUN NOUN VERB CCONJ VERB VERB AUX PUNCT
Yaptığı başarılı işlere rağmen çok mütevazi bir insan olduğundan dolayı övülmeyi hiç sevmezdi .	VERB ADJ NOUN ADP ADV ADJ DET NOUN VERB ADP VERB ADV VERB PUNCT
Aylarca yılmadan çalışan ekip , ortaya mükemmel bir proje çıkartarak dereceye girdi .	ADV VERB VERB NOUN PUNCT ADJ ADJ DET NOUN VERB NOUN VERB PUNCT
Hayatımda gördüğüm en mantık lı insandı , attığı her adımdan önce o adımın sonuçlarını düşünürdü .	ADJ VERB ADV NOUN ADP VERB PUNCT VERB DET NOUN ADP DET NOUN NOUN VERB PUNCT
Yıllarca süründükten sonra şans eseri bir gecede yıldızı parladı ve bu günlere geldi .	ADV VERB ADP NOUN NOUN DET NOUN NOUN VERB CCONJ DET NOUN VERB PUNCT
Film galasında giydiği modası geçmiş giysilerle hepimizin gözlerini kanattı .	NOUN NOUN VERB NOUN ADJ NOUN NOUN NOUN VERB PUNCT
Asosyal bir insan olması nedeniyle hiç arkadaşı yok tu , hep yalnızdı .	ADJ DET NOUN VERB NOUN ADV NOUN ADV AUX PUNCT ADV VERB PUNCT
Düşmanca tavırları artık kendisine zarar vermeye başlamıştı , herkes ondan uzaklaşıyordu .	ADJ NOUN ADV PRON NOUN VERB VERB PUNCT NOUN PRON VERB PUNCT
Aralarında kan davası bulunan iki ailenin düşmanlıkları bir türlü sona ermiyordu .	ADJ NOUN NOUN VERB NUM NOUN NOUN NUM ADJ ADJ VERB PUNCT
Babası , annesini ve kendisini 10 yıl önce terk etmiş ve asla geri dönmemiş .	NOUN PUNCT NOUN CCONJ PRON NUM NOUN ADP NOUN VERB CCONJ ADV ADJ VERB PUNCT
O kadar iğrenç bir insan ki hepimiz ondan nefret ediyoruz .	PRON ADP ADJ DET NOUN CCONJ PRON PRON NOUN VERB PUNCT
Yapılan araştırmalara göre Türkiye ' de yoksulluk oranı her geçen gün artıyor .	VERB VERB ADP PROPN PUNCT CCONJ NOUN NOUN DET ADJ NOUN VERB PUNCT
Konferansta saçma söylemlerde bulunan kişiyi hiçkimse sevmiyordu .	NOUN ADJ NOUN VERB NOUN ADV VERB PUNCT
Bursa - İzmir yolunda meydana gelen kazada 5 ölü , 6 yaralı bulunuyor .	PROPN PUNCT PROPN NOUN NOUN VERB NOUN NUM NOUN PUNCT NUM NOUN VERB PUNCT
Rivayete göre , Derecik köyünde bulunan lanet li eve girenler geri çıktıklarında psikolojileri bozuluyormuş .	NOUN ADP PUNCT PROPN NOUN VERB NOUN ADP NOUN ADJ ADJ VERB NOUN VERB PUNCT
Uyuşturucu bağımlılığı her yıl milyonlarca gencin hayatını söndürüyor .	ADJ NOUN DET NOUN NUM ADJ NOUN VERB PUNCT
Başımın ağrısı o kadar kuvvet liydi ki öleceğimi zannettim .	NOUN NOUN PRON ADP NOUN ADP CCONJ VERB VERB PUNCT
Türkiye ' de toplumsal şiddet her geçen gün artıyor .	PROPN PUNCT CCONJ ADJ NOUN DET ADJ NOUN VERB PUNCT
Karşıya geçmek isterken kamyonun altında kalan kadının hayatını kaybettiği anlar yayında .	ADJ VERB VERB NOUN ADJ VERB NOUN NOUN VERB NOUN NOUN PUNCT
O kadar antipatik bir insandı ki her gördüğümde yeniden tiksiniyordum .	PRON ADP ADJ DET VERB CCONJ DET VERB ADV VERB PUNCT
Egoist bir insan olduğu için onunla konuşmamayı tercih ediyorum .	ADJ DET NOUN VERB ADP PRON VERB NOUN VERB PUNCT
Kendini beğenmiş , burnu havada dolanan mızmızın teki ydi .	PRON VERB PUNCT NOUN NOUN VERB NOUN ADJ AUX PUNCT
Her yıl kanserden dolayı ortalama 10 milyon ölüm gerçekleşiyor .	DET NOUN NOUN ADP ADJ NUM NUM NOUN VERB PUNCT
Korona yüzünden asosyal insanlara dönüştük , evden dışarı çıkamıyoruz .	PROPN NOUN ADJ NOUN VERB PUNCT NOUN NOUN VERB PUNCT
Onun , bugün derste hocaya yaptığı hareket çok saçma ydı .	PRON PUNCT NOUN NOUN NOUN VERB NOUN ADV ADJ AUX PUNCT
1 hafta dır yaptığı saçma hareketlerle beni kışkırtmaya çalışıyor , en sonunda kendime hakim olamayacağım .	NUM NOUN ADP VERB ADJ NOUN PRON VERB VERB PUNCT ADV ADV PRON NOUN VERB PUNCT
İzlediğimiz film o kadar korkunçtu ki kalp krizi geçirmemize ramak kalmıştı .	VERB NOUN DET ADP VERB CCONJ NOUN NOUN VERB ADJ VERB PUNCT
Son günlerde gizli bir numara beni arayarak sürekli rahatsız ediyor .	ADJ NOUN ADJ DET NOUN PRON VERB ADV ADJ VERB PUNCT
Ona o kadar kızgınım ki bir daha yüzünü bile görmek istemiyorum .	PRON DET ADP VERB CCONJ ADV ADV NOUN ADV VERB VERB PUNCT
Yaptığı hatanın farkına varıp , düzeltmeden artık hayatımda ona yer yok .	VERB NOUN NOUN VERB PUNCT VERB ADV NOUN PRON NOUN ADJ PUNCT
Projemizden başarılı bir sonuç elde etmeyi dört gözle bekliyoruz .	NOUN ADJ DET NOUN NOUN VERB NUM NOUN VERB PUNCT
Yarın planladığımız geziye ne yazık ki gidemeyeceğiz .	NOUN VERB NOUN PRON NOUN CCONJ VERB PUNCT
Burada ki markette istediğim markanın ürününü bulamadığım için şanssız hissediyorum .	NOUN ADP NOUN VERB NOUN NOUN VERB ADP ADJ VERB PUNCT
Eyvah ! Hem Türkçe hem Matematik ödevimi yapmayı unuttum .	NOUN PUNCT CCONJ PROPN CCONJ NOUN NOUN VERB VERB PUNCT
Bu eser serginin olmazsa olmaz eşsiz parçalarından birisi dir .	DET NOUN NOUN VERB VERB ADJ NOUN PRON AUX PUNCT
Tüh ! Sınavda bu soruyu böyle çözmek aklıma bir türlü gelmedi .	PROPN PUNCT NOUN DET NOUN ADV VERB NOUN NUM ADJ VERB PUNCT
Böyle büyük bir sorunla nasıl başa çıkacağımı hiç bilmiyorum .	ADV ADJ DET NOUN ADV NOUN VERB ADV VERB PUNCT
Günün birinde bu kötü sır büyük bir olayın başlangıcı olacak .	NOUN NUM DET ADJ NOUN ADJ DET NOUN NOUN VERB PUNCT
Böyle giderse bu ödevden iyi bir puan alamayacağız .	ADV VERB DET NOUN ADJ DET NOUN VERB PUNCT
Küçüklüğümden beri voleybol oynamakla aram baya iyi dir .	NOUN ADP NOUN VERB NOUN ADV ADJ AUX PUNCT
Gelecekte çocuklarım için güven li ve sağlık lı bir yaşam diliyorum .	NOUN NOUN ADP NOUN ADP CCONJ NOUN ADP DET NOUN VERB PUNCT
Bu çiçekleri çabuk iyileşebilmen dileğiyle sana gönderdim .	DET NOUN ADV VERB ADV PRON VERB PUNCT
Seneye iyi bir üniversitede okuyacağın için şimdiden tebrik ediyorum .	NOUN ADJ DET NOUN VERB ADP ADV NOUN VERB PUNCT
Yalan söylenmesinden hoşlanmadığımı bile bile bunu yaptığın için seni asla affetmeyeceğim .	ADJ VERB VERB ADV VERB PRON VERB ADP PRON ADV VERB PUNCT
Böyle bir etkinlik için zaman ayırdığıma inanamıyorum .	ADJ DET NOUN ADP NOUN VERB VERB PUNCT
Yaptığınız kaba ve kötü davranışlar doğrultusunda işinize son vermek zorunda yım .	VERB ADJ CCONJ ADJ NOUN NOUN NOUN ADJ VERB NOUN AUX PUNCT
Yarın ki doğum günü partimi düşündükçe heyecandan yerimde duramıyorum .	NOUN ADP NOUN NOUN NOUN VERB NOUN NOUN VERB PUNCT
Günün bir kısmını kardeşlerimle geçirmek kadar güzel bir şey yok .	NOUN DET NOUN NOUN VERB ADP ADJ NUM NOUN ADJ PUNCT
En ufak bir olayda anında şiddete başvuran insanlardan haz etmiyorum .	ADV ADJ DET NOUN NOUN NOUN VERB NOUN NOUN VERB PUNCT
Biraz önce duyduğum şey hayatımda ki en saçma fikirlerden biri ydi .	ADV ADV VERB NOUN NOUN ADP ADV ADJ NOUN PRON AUX PUNCT
Ne olursa olsun yanımda durmaktan vazgeçmediğin için teşekkür ederim .	PRON VERB VERB ADJ VERB VERB ADP NOUN VERB PUNCT
Beklediğim kadar iyi bir tecrübe edinemediğim için üzgünüm .	VERB ADP ADJ DET NOUN VERB ADP VERB PUNCT
Bugüne kadar yapmış oldukların arasında en berbat olanı bu ydu .	NOUN ADP VERB VERB ADJ ADV ADJ NOUN PRON AUX PUNCT
Onun açısından düşününce bunun fayda lı olacağını düşünmüyorum .	PRON NOUN VERB PRON NOUN ADP ADJ VERB PUNCT
Onunla gözgöze geldiğimde nedenini bilmediğim bir şekilde donup kalmıştım .	PRON NOUN VERB NOUN VERB DET NOUN ADV VERB PUNCT
Mahsur kaldığımız orman zifiri karanlık ve çok tenha bir yerde olunca arkadaşım korkudan bayıldı .	ADJ VERB NOUN NOUN ADJ CCONJ ADV ADJ DET NOUN VERB NOUN NOUN VERB PUNCT
Gideceğimiz yerde çok rahat bir şekilde yaşayabileceğimiz için bizden mutlusu yok .	VERB NOUN ADV ADJ DET NOUN VERB ADP PRON ADJ ADJ PUNCT
Başladığın bir işi bu kadar kusursuz yapılabileceğini hiç hayal etmemiştim .	VERB DET NOUN PRON ADP ADJ VERB ADV NOUN VERB PUNCT
Durduğumuz dinlenme tesisi muhteşem bir manzaraya sahipti .	VERB VERB NOUN ADJ DET NOUN VERB PUNCT
Böyle bir durumla tek başına başa çıkabileceğini düşünmek akıl karı değildi .	ADJ DET NOUN ADJ NOUN NOUN VERB VERB NOUN NOUN AUX PUNCT
Ailem yanımda olduğu sürece sırtımın yere gelmeyeceğini biliyorum ve seviniyorum .	NOUN ADJ VERB NOUN NOUN NOUN VERB VERB CCONJ VERB PUNCT
Annesi çocuğunun kötü bir şey yaptığını düşünmediği için onu uyarma gereği duymadı .	NOUN NOUN ADJ NUM NOUN VERB VERB ADP PRON VERB NOUN VERB PUNCT
Başımdan geçen onca olaya rağmen iyi düşünmeye çalışıyorum .	NOUN VERB DET NOUN ADP ADJ VERB VERB PUNCT
İnsanların bana dik dik bakması beni çok rahatsız ediyor .	NOUN PRON ADJ ADJ VERB PRON ADV ADJ VERB PUNCT
Günün sonunda yine ben kazanmış olacağım için hiç olmadığım kadar mutluyum .	NOUN ADV ADV PRON VERB VERB ADP ADV VERB ADP VERB PUNCT
Yaptığı hatayı telafi etmek için bu kadar çabaladığını görünce onun hakkında düşüncelerim iyi yönde değişti .	VERB NOUN NOUN VERB ADP DET ADP VERB VERB PRON NOUN NOUN ADJ NOUN VERB PUNCT
Hayatımda bir şeylerin yolunda gitmesi için daha ne kadar çabalamam gerektiği hakkında hiçbir fikrim yok .	NOUN DET NOUN NOUN VERB ADP ADV PRON ADP VERB VERB NOUN DET NOUN ADJ PUNCT
Gün geçtikçe aramızda ki ilişkinin daha da büyümesi beni hiç olmadığım kadar mutlu ediyor .	NOUN VERB ADJ ADP NOUN ADV CCONJ VERB PRON ADV VERB ADP ADJ VERB PUNCT
Güvendiğim kişilerle birlikte olunca hiçbir şüphe duymadan istediğim yolda yürümeye devam edebiliyorum .	VERB NOUN ADP VERB DET NOUN VERB VERB NOUN VERB NOUN VERB PUNCT
Sayısal analiz dersinin final sınavından 80 puan alıp dersi geçtiğim için çok mutlu yum .	ADJ NOUN NOUN NOUN NOUN NUM NOUN VERB NOUN VERB ADP ADV ADJ AUX PUNCT
Bu yıl da geçen seneki gibi elemeleri geçip mülakata gireceğim için çok hevesli yim .	DET NOUN CCONJ ADJ NOUN ADP NOUN VERB NOUN VERB ADP ADV ADJ AUX PUNCT
Bu sene baharda havalar çok güzel olduğu için her hafta sonu pikniğe gittik .	DET NOUN NOUN NOUN ADV ADJ VERB ADP DET NOUN ADJ NOUN VERB PUNCT
Bugün ilk dersimiz beden eğitimi olduğu için kendimi enerjik hissediyorum .	NOUN ADJ NOUN NOUN NOUN VERB ADP PRON ADJ VERB PUNCT
Bu hafta sonu girdiğim ehliyet sınavı çok iyi geçtiği için yarın akşam arkadaşlarımla kutlama yemeğine çıkacağız .	DET NOUN ADJ VERB NOUN NOUN ADJ ADJ VERB ADP NOUN NOUN NOUN VERB NOUN VERB PUNCT
Bu sene Haziran ayında üniversiteden mezun olacağım için çok sevinçli yim .	DET NOUN NOUN NOUN NOUN ADJ VERB ADP ADV ADJ AUX PUNCT
Bu hafta pazar günü ailemle birlikte kahvaltıya çıkıp keyif li bir gün geçirdik .	DET NOUN NOUN NOUN NOUN ADP NOUN VERB NOUN ADP DET NOUN VERB PUNCT
Ayşe geçen sene gittiği ingilizce kursu sayesinde erasmus sınavını kazandı .	PROPN ADJ NOUN VERB NOUN NOUN NOUN NOUN NOUN VERB PUNCT
Mahallede ki çocuklar okullarının bahçesine park yapıldığı için çok sevinçli görünüyorlar .	NOUN ADP NOUN NOUN NOUN NOUN VERB ADP ADV ADJ VERB PUNCT
Bugün kedisinin 3 yaş doğum gününü kutlarken yeni kedi sahipleneceği haberini duyurduğu için çok mutlu ydu .	NOUN NOUN NUM ADJ NOUN NOUN VERB ADJ NOUN VERB NOUN VERB ADP ADV ADJ AUX PUNCT
Düğünde giydiği siyah elbise onun üzerinde çok büyüle yici görünüyordu .	NOUN VERB ADJ NOUN PRON NOUN ADV ADJ ADP VERB PUNCT
İrem 23 Nisan Ulusal Egemenlik ve Çocuk Bayramı için yazdığı şiiri coşkulu bir şekilde okudu .	PROPN NUM NOUN ADJ NOUN CCONJ NOUN NOUN ADP VERB NOUN ADJ DET NOUN VERB PUNCT
Nazlı Kemal ' in evlilik teklifi için aldığı çiçekleri ve yüzüğü çok beğendiğini söyledi .	PROPN PROPN PUNCT ADP NOUN NOUN ADP VERB NOUN CCONJ NOUN ADV VERB VERB PUNCT
Geçen sene yazın ailem ile birlikte gittiğimiz Demet Akalın ve Hadise konseri muhteşemdi .	ADJ NOUN NOUN NOUN CCONJ ADP VERB PROPN PROPN CCONJ NOUN NOUN VERB PUNCT
Üstün başarılarından dolayı bu sene de ödül aldığı için kardeşi Fatma ile gurur duyuyordu .	ADJ NOUN ADP DET NOUN CCONJ NOUN VERB ADP NOUN PROPN CCONJ NOUN VERB PUNCT
Yeni sahiplendiği kedinin sağlıklı olduğunu öğrendiğinden beri içi çok rahatladı .	ADJ VERB NOUN ADJ VERB VERB ADP ADJ ADV VERB PUNCT
Şirkette ki başarılarından dolayı Alperen ' e onur ve başarı belgesi takdim edildi .	NOUN ADP NOUN ADP PROPN PUNCT ADP PROPN CCONJ NOUN NOUN NOUN VERB PUNCT
Sonunda ingilizce kursunun sınavında başarılı olup bir kur daha atlayabildiği için çok sevinçli ydi .	ADV NOUN NOUN NOUN ADJ VERB DET NOUN ADV VERB ADP ADV ADJ AUX PUNCT
Bu sene yapacakları projenin sonunda para ödülü verilecek olması onları motive etti .	DET NOUN VERB NOUN ADV NOUN NOUN VERB VERB PRON NOUN VERB PUNCT
Okul hayatı boyunca başarılı bir öğrenci olup hep takdir belgesi almış .	NOUN NOUN ADP ADJ DET NOUN VERB ADV NOUN NOUN VERB PUNCT
Yaptığı ilk iş başvurusu kısa sürede kabul edilince sevinç çığlıkları atmaya başladı .	VERB ADJ NOUN NOUN ADJ NOUN NOUN VERB NOUN NOUN VERB VERB PUNCT
Ali bu sene ilkokul 1 . sınıfa başlayacağı için çok heyecanlı ydı .	PROPN DET NOUN NOUN NUM PUNCT NOUN VERB ADP ADV ADJ AUX PUNCT
Bu yıl doğum gününde hediye ettiğim beyaz elbiseyi çok beğendiğini söyledi .	DET NOUN NOUN NOUN NOUN VERB ADJ NOUN ADV VERB VERB PUNCT
Tatilde kaldığım 5 yıldızlı otelin balkonunun manzarasının güzelliği hala aklımdan çıkmıyor .	NOUN VERB NUM ADJ NOUN NOUN NOUN NOUN ADV NOUN VERB PUNCT
Geçtiğimiz yıl Ekim ayında bahçesine diktiği tüm fidanlar tuttuğu için çok mutlu .	VERB NOUN NOUN NOUN NOUN VERB DET NOUN VERB ADP ADV ADJ PUNCT
Prison Break bugüne dek hayatımda izlediğim en kötü senaryolu dizi ydi .	PROPN PROPN NOUN ADP NOUN VERB ADV ADJ ADJ NOUN AUX PUNCT
Mehmet hasta olduğu için annesi bu hafta okula gelemeyeceğini söyledi .	PROPN ADJ VERB ADP NOUN DET NOUN NOUN VERB VERB PUNCT
Ayşe bu sene kayak yaparken ayağını kırdığı için olimpiyatlara katılmayacak .	PROPN DET NOUN NOUN VERB NOUN VERB ADP NOUN VERB PUNCT
Derslerine çalışmayıp sınavda dereceye giremediği için bütün gün çok ağlamış .	NOUN VERB NOUN NOUN VERB ADP ADJ NOUN ADV VERB PUNCT
2020 yılında korona virüs hastalığı başladığı için hiç güzel bir sene değildi .	NUM NOUN NOUN NOUN NOUN VERB ADP ADV ADJ DET NOUN AUX PUNCT
Çocukken mutfakta yaşadığım talihsizlikten dolayı yemek yapmayı hiç sevmiyorum .	NOUN NOUN VERB NOUN ADP NOUN VERB ADV VERB PUNCT
Yeni evine taşınırken çalışma masası kırıldığı için çok üzgün görünüyordu .	ADJ NOUN VERB VERB NOUN VERB ADP ADJ ADJ VERB PUNCT
Çalıştığı fabrikada patronu kötü davrandığı için bu hafta istifa dilekçesini verecekmiş .	VERB NOUN NOUN ADJ VERB ADP DET NOUN NOUN NOUN VERB PUNCT
Beyza bu hafta kar yağışı hiç durmadığı için iş seyahatine çıkamadı .	PROPN DET NOUN NOUN NOUN ADV VERB ADP NOUN NOUN VERB PUNCT
Kuzenim yeni aldığı bisikleti sürerken taşlı yollarda dengesini kaybedip düşmüş .	NOUN ADJ VERB NOUN VERB ADJ NOUN NOUN VERB VERB PUNCT
Bütün çocuklar babası ve annesi tartıştığı zaman bundan kötü etkilenip üzülür .	ADJ NOUN NOUN CCONJ NOUN VERB NOUN PRON ADJ VERB VERB PUNCT
Üniversite yemekhanesinde ki yemeklerin içinde çok fazla tuz olduğu için bugün kimse yemek yiyemedi .	NOUN NOUN ADP NOUN ADJ ADV ADV NOUN VERB ADP NOUN NOUN NOUN VERB PUNCT
Köyde ki çiftçiler bu yıl kuraklıktan dolayı hasatın çok kötü geçtiğini söylediler .	NOUN ADP ADJ DET NOUN NOUN ADP NOUN ADV ADJ VERB VERB PUNCT
İzmir ' de çalıştığı dönemde geçirdiği trafik kazası sonucu amcam vefat etti .	PROPN PUNCT CCONJ VERB NOUN VERB NOUN NOUN NOUN NOUN NOUN VERB PUNCT
Kötü hava koşullarından dolayı İstanbul Sabiha Gökçen havalimanında ki tüm uçuşlar iptal edildi .	ADJ NOUN NOUN ADP PROPN PROPN PROPN NOUN ADP DET NOUN NOUN VERB PUNCT
Kardeşim bu hafta içi girdiği futbol müsabakasını kaybettiği için çok ağladı .	NOUN DET NOUN ADJ VERB NOUN NOUN VERB ADP ADV VERB PUNCT
Geçtiğimiz hafta yağmurlu havada yürüyüşe çıktığı için üşütüp hasta oldu .	VERB NOUN ADJ NOUN NOUN VERB ADP VERB ADJ VERB PUNCT
İnternetten sipariş verdiğim ürün bir hafta dır kargoya verilmediği için siparişi iptal etmek zorunda kaldım .	NOUN NOUN VERB NOUN NUM NOUN ADP NOUN VERB ADP NOUN NOUN VERB ADJ VERB PUNCT
Bu sene İzmir ' de olan depremde binaların temelleri sağlam olmadığı için yıkılmış .	DET NOUN PROPN PUNCT CCONJ VERB NOUN NOUN NOUN ADJ VERB ADP VERB PUNCT
Kaldığım yurtta soğuk havalarda kaloriferleri açmadıkları için hasta oldum ve okula gidemedim .	VERB NOUN ADJ NOUN NOUN VERB ADP ADJ VERB CCONJ NOUN VERB PUNCT
O projelerde etkin olarak rol üstlenen bir öğrenci olmadığı için düşük not aldı .	DET NOUN ADJ ADP NOUN VERB DET NOUN VERB ADP ADJ NOUN VERB PUNCT
Kütahya ' da kaldığımız zaman yemekhanede yediğimiz yemeklerden zehirlendik ve hepimiz hasta olduk .	PROPN PUNCT CCONJ VERB NOUN NOUN VERB NOUN VERB CCONJ PRON ADJ VERB PUNCT
Ayşe ikinci kez korona virüs hastalığına yakalandığı için çok mutsuzdu .	PROPN ADJ NOUN NOUN NOUN NOUN VERB ADP ADV VERB PUNCT
Merdivenlerden inerken dengesini kaybedip yere düştü ve maalesef ayağı kırıldı .	NOUN VERB NOUN VERB NOUN VERB CCONJ ADV NOUN VERB PUNCT
Akşam yemeği için vermiş olduğum yemek siparişim çok geç geldiğinden dolayı yemekler soğumuştu .	NOUN NOUN ADP VERB VERB NOUN NOUN ADV ADV VERB ADP NOUN VERB PUNCT
Geçen yıl doğum gününde iki arkadaşının birlikte aldığı çanta çok güzeldi .	ADJ NOUN NOUN NOUN NUM NOUN ADP VERB NOUN ADV VERB PUNCT
Bu kitap son zamanlarda okuduğum en güzel ve etkile yici kitaptı .	DET NOUN ADJ NOUN VERB ADV ADJ CCONJ NOUN ADP VERB PUNCT
Yetenekli olduğu için ilkokul öğretmeninin yönlendirmesiyle severek resim çizmeye başlamıştı .	ADJ VERB ADP NOUN NOUN NOUN ADV NOUN VERB VERB PUNCT
İstediği bölümü kazanmış olduğu için okulun açılmasını dört gözle bekliyordu .	VERB NOUN VERB VERB ADP NOUN VERB NUM NOUN VERB PUNCT
Gökyüzünde ki uçakları izlerken hayal kurmak bugünlerde en çok sevdiği şeydi .	NOUN ADP NOUN VERB NOUN VERB NOUN ADV ADJ VERB NOUN PUNCT
Ailesine göre sesi güzel olduğu için şarkı söylemeyi çok seviyordu .	NOUN ADP NOUN ADJ VERB ADP NOUN VERB ADV VERB PUNCT
Babasının da dediği gibi birkaç günlük tatil fikri fena değilmiş .	NOUN CCONJ VERB ADP DET ADJ NOUN NOUN ADJ AUX PUNCT
Burada ki anılarından uzaklaşmak hepsine çok iyi gelecektir .	NOUN ADP NOUN VERB PRON ADV ADJ VERB PUNCT
Yıllar dır o çok istediği motorsikleti karşısında görünce sevinçten havalara uçtu .	NOUN ADP PRON ADV VERB NOUN ADJ VERB NOUN NOUN VERB PUNCT
Bugün olduğu gibi yağmurlu havalarda yürüyüş yapmak hep iyi geliyordu .	NOUN VERB ADP ADJ NOUN NOUN VERB ADV ADJ VERB PUNCT
Doğum gününde sevdiklerinin kendisine aldığı hediyeleri gerçekten çok beğenmişti .	NOUN NOUN ADJ PRON VERB NOUN ADV ADV VERB PUNCT
Onun şu güne kadar yapmış olduğu en güzel yemek bu ydu .	PRON DET NOUN ADP VERB VERB ADV ADJ NOUN PRON AUX PUNCT
Murat yaşadığı son şeylerden sonra artık halinden gayet memnundu .	PROPN VERB ADJ NOUN ADP ADV NOUN ADV VERB PUNCT
Yıllar dır almayı çok istediği kemanı sonunda aldığı için mutlu olmuştu .	NOUN ADP VERB ADV VERB NOUN ADV VERB ADP ADJ VERB PUNCT
Sesi o kadar güzeldi ki dinleyen herkesi sesiyle büyülemeyi başarmıştı .	NOUN PRON ADP VERB CCONJ VERB NOUN NOUN VERB VERB PUNCT
Tuttukları takım şampiyon olunca taraftarların yaşadığı sevinç tarif edilemeyecek kadar büyük tü .	VERB NOUN ADJ VERB ADJ VERB NOUN NOUN VERB ADP ADJ AUX PUNCT
Okula gelmeden önce aldığı güzel haber ile artık içi içine sığmıyordu .	NOUN VERB ADP VERB ADJ NOUN CCONJ ADV ADJ ADJ VERB PUNCT
Geçen gün beğenerek aldığı kırmızı montu ona gerçekten çok yakışmıştı .	ADJ NOUN VERB VERB ADJ NOUN PRON ADV ADV VERB PUNCT
Aldığı haberle birlikte parlamaya başlayan yeşil gözleri mutluluğunu belli ediyordu .	VERB NOUN ADP VERB VERB ADJ NOUN NOUN ADJ VERB PUNCT
Çok sevdiği bir arkadaşının almasıyla birlikte orkide artık en sevdiği çiçekti .	ADJ VERB DET NOUN VERB ADP NOUN ADV ADV VERB VERB PUNCT
Müzik dinleyerek yemek yapmak uzun zaman dır hobileri arasında bulunuyordu .	NOUN VERB NOUN VERB ADJ NOUN ADP NOUN ADJ VERB PUNCT
Birkaç gün dür hasta olduğu için okula gelmeyen arkadaşının geleceğini duyunca sevindi .	DET NOUN AUX ADJ VERB ADP NOUN VERB NOUN ADJ VERB VERB PUNCT
Geçen gün kırılan vazonun yenisi ile değiştirilmiş olduğunu görünce gülümsedi .	ADJ NOUN VERB NOUN NOUN CCONJ VERB VERB VERB VERB PUNCT
Defne yapılan bu güzel sürpriz karşısında heyecandan ne diyeceğini şaşırmıştı .	NOUN VERB DET ADJ NOUN ADJ NOUN PRON VERB VERB PUNCT
Burada ki herkesin yardımıyla kısa sürede büyük bir ailesi olduğu için mutlu ydu .	NOUN ADP NOUN NOUN ADJ NOUN ADJ DET NOUN VERB ADP ADJ AUX PUNCT
Bu sefer yaptığı yemek daha önce yaptıkları kadar güzel değildi .	DET NOUN VERB NOUN ADV ADV VERB ADP ADJ AUX PUNCT
Böyle bulutlu havalarda dışarı çıkmak ya da bir şey yapmak içinden gelmiyordu .	ADV ADJ NOUN NOUN VERB CCONJ CCONJ NUM NOUN VERB ADJ VERB PUNCT
Üşüyen ellerini soğuktan korumak için taktığı eldivenlerini nereye koyduğunu bilmiyordu .	VERB NOUN NOUN VERB ADP VERB NOUN PRON VERB VERB PUNCT
Arkadaşı ; yıllar dır kullandığı ve onun için değerli olan kalemi kaybetmişti .	NOUN PUNCT NOUN ADP VERB CCONJ PRON ADP ADJ VERB NOUN VERB PUNCT
İnsanların sürekli ona yalan söyleyip bir şeyler saklamasından nefret ediyordu .	NOUN ADV PRON ADJ VERB NUM NOUN VERB NOUN VERB PUNCT
Ailesinden ayrılıp üniversite okumak için geldiği bu şehirde çok yalnızdı .	NOUN VERB NOUN VERB ADP VERB DET NOUN ADV VERB PUNCT
Bu yarışmada çizdiği resim şuana kadar ki en iyi çalışması değildi .	DET NOUN VERB NOUN NOUN ADP ADP ADV ADJ VERB AUX PUNCT
Yapmak isteyip de yapmaya fırsat bulamadığım çok şey var , dedi .	VERB VERB CCONJ VERB NOUN VERB ADJ NOUN ADJ PUNCT VERB PUNCT
Henüz ehliyeti olmadığı için araba kullanamıyor oluşu onu gerçekten üzüyordu .	ADV NOUN VERB ADP NOUN VERB NOUN PRON ADV VERB PUNCT
Son yaşananlardan sonra burada olmak kendini kötü hissetmesine sebep oluyordu .	ADJ VERB ADP NOUN VERB PRON ADJ VERB NOUN VERB PUNCT
Onu hiçbir şey olmamış gibi karşısında görünce öfkeden deliye döndü .	PRON DET NOUN VERB ADP ADJ VERB NOUN ADJ VERB PUNCT
Bu yaptığı şey onun için elinden gelenin en iyisi değildi .	DET VERB NOUN PRON ADP NOUN VERB ADV ADJ AUX PUNCT
Uzun zaman sonra birlikte gittikleri yerde güzel vakit geçirmiş sayılmazdı .	ADJ NOUN ADP ADP VERB NOUN ADJ NOUN VERB VERB PUNCT
Bu konuda ki davranışları diğerlerinin aksine hiç yaşına göre uygun değildi .	DET NOUN ADP NOUN NOUN ADV ADV ADJ ADP ADJ AUX PUNCT
Durumun iyi olacağına dair küçük bir umudu dahi yok tu artık .	NOUN ADJ VERB ADP ADJ DET NOUN ADJ ADV AUX ADV PUNCT
Okula gelirken giydiği mavi gömlek ile hiç de iyi görünmüyordu	NOUN VERB VERB ADJ NOUN CCONJ ADV CCONJ ADJ VERB
Ödeve başlarken sonrasında neler yapması gerektiğini düşünmek bile istemiyordu .	NOUN VERB NOUN PRON VERB VERB VERB ADV VERB PUNCT
İki yıl önce gittiği konsere göre bu yılki konser iyi bile değildi .	NUM NOUN ADP VERB NOUN ADP DET ADJ NOUN ADJ ADV AUX PUNCT
Sipariş ettiği kitaplar baskısı olmadığı için bir ay geç geldi .	NOUN VERB NOUN NOUN VERB ADP DET NOUN ADV VERB PUNCT
Çalan şarkı ile birlikte aklına gelenler yüzünden gözleri dolmuştu .	VERB NOUN ADP ADP NOUN ADJ NOUN NOUN VERB PUNCT
Evden gelen sesler ile birlikte hırsız girdiğini düşünüp çok kokrmuştu .	NOUN VERB NOUN ADP ADP ADJ VERB VERB ADV VERB PUNCT
Babasının bu doğum gününde aldığı oyuncak araba önceki ler kadar iyi değildi .	NOUN DET NOUN NOUN VERB NOUN NOUN DET ADP ADP ADJ AUX PUNCT
Hep birlikte gideceğimiz müze gezisinin salgın nedeniyle iptal olması bizi üzdü .	ADV ADP VERB NOUN NOUN NOUN NOUN NOUN VERB PRON VERB PUNCT
Begüm ablasıyla birlikte izlediği filmden çok etkilenmiş günlerce ağlamıştı .	PROPN NOUN ADP VERB NOUN ADV VERB ADV VERB PUNCT
Gün geçtikçe hayata dair umutlarının artık tamamen tükendiğini düşünüyordu	NOUN VERB NOUN ADP NOUN ADV ADV VERB VERB
Kendimde ki ve etrafımda ki olayları gün geçtikçe daha iyi anlamaya başlıyoru m	NOUN ADP CCONJ NOUN ADP NOUN NOUN VERB ADV ADJ VERB VERB NOUN
Bazıları müzik dinlemekten , bazıları da resim yapmaktan hoşlanır .	PRON NOUN VERB PUNCT PRON CCONJ NOUN VERB VERB PUNCT
Bu akşam Ahmet ve Selin ile dışarıda meyhaneye gideceğiz .	DET NOUN PROPN CCONJ PROPN CCONJ NOUN NOUN VERB PUNCT
Enver bey , projemiz hakkında sizi detaylı olarak bilgilendirece k	PROPN NOUN PUNCT NOUN NOUN PRON ADJ ADP VERB NOUN
Dün akşam babamla birlikte harika bir kovboy filmi izledi k	NOUN NOUN NOUN ADP ADJ DET NOUN NOUN VERB NOUN
En zor anında insanın yanında olan ailesi ve dostlarıymı ş	ADV ADJ NOUN NOUN ADJ VERB NOUN CCONJ ADJ NOUN
Aklımda nice dir gerçekleştirmek istediğim birçok hayal var .	NOUN ADV AUX VERB VERB DET NOUN ADJ PUNCT
İnan ben de çocukluğumun geçtiği sokakları çok özledi m	VERB PRON CCONJ NOUN VERB NOUN ADV VERB NOUN
Öğretmenin sorduğu tüm sorulara doğru yanıt ver di	NOUN VERB DET NOUN ADJ NOUN VERB AUX
Önce arabanın ruhsatını verdi , sonra parayı alıp anahtarı verdi .	ADV NOUN NOUN VERB PUNCT ADV NOUN VERB NOUN VERB PUNCT
Freelance yaparak " Digital Nomad " olmak istiyoru m	PROPN VERB PUNCT PROPN PROPN PUNCT VERB VERB NOUN
İki gün sonra benim maaş hesabıma yatmış olacak ondan sonra gezmeye gidebiliriz	NUM NOUN ADP PRON NOUN NOUN VERB VERB PRON ADP VERB VERB
Yarın Charlotte Cardin konseri olacak beraber gide li m	NOUN PROPN PROPN NOUN VERB ADP NOUN ADP NOUN
3D yazıcı alıcak param var artık	NUM NOUN VERB NOUN ADJ ADV
Arkadaşlarla bu akşam toplanıp FRP oynadık	NOUN DET NOUN VERB NOUN VERB
Bugün fransızcada kendimi biraz daha geliştirdiğimi hissediyoru m	NOUN NOUN PRON ADV ADV VERB VERB NOUN
Artık yurtdışına çıkabilecek param var ve ilk olarak İtalya ' ya gideceği m	ADV NOUN VERB NOUN ADJ CCONJ ADV ADP PROPN PUNCT ADP VERB NOUN
Artık havalar baya ısınmaya başladı kış bitmiş gibi	ADV NOUN NOUN VERB VERB NOUN VERB ADP
Seni mutlu görmek beni mutlu ediyor	PRON ADJ VERB PRON ADJ VERB
Kedim kanserini atlattı artık rahatlayabiliriz	NOUN NOUN VERB ADV VERB
Bu akşam baya lezzet li ve doyurucu bir yemek yedi k	DET NOUN NOUN NOUN ADP CCONJ ADJ DET NOUN VERB NOUN
Erasmusa seçilmişim diğer dönem Almanya ' da okuyacağı m	PROPN VERB ADJ NOUN PROPN PUNCT CCONJ VERB NOUN
Su samurları aşırı tatlı hayvanlar	NOUN NOUN ADJ ADJ ADJ
Dün Ramstein yeni teklisi çıkmış ve aşırı güzel olmuş .	NOUN PROPN ADJ NOUN VERB CCONJ ADJ ADJ VERB PUNCT
Yeni bir hobi edindim o da figür tasarımı .	ADJ DET NOUN VERB PRON CCONJ NOUN NOUN PUNCT
Sağ ayağıma artık düzgün basamıyorum .	ADJ NOUN ADV ADJ VERB PUNCT
Maaşım artık bana yetmemeye başladı	NOUN ADV PRON VERB VERB
Bana sorarsan bu problemi öğretmen dahi çözemez	PRON VERB DET NOUN NOUN ADJ VERB
3D yazıcımın ucunda arıza çıktı artık düzgün çalışmıyor	NUM NOUN NOUN NOUN VERB ADV ADJ VERB
Senin kitabını almak istemiyorum bana hitap etmiyor .	PRON NOUN VERB VERB PRON NOUN VERB PUNCT
Trafik tıkandığı için vaktinde yetişemeyeceği m	NOUN VERB ADP NOUN VERB NOUN
Pazardan aldığım meyveler ne kadar lezzetsizmi ş	NOUN VERB NOUN PRON ADP NOUN NOUN
Onun büyük sorun yaşamasına neden olan hastalığı sebebiyle çok fazla mutsuzdu m	PRON ADJ NOUN VERB NOUN VERB NOUN NOUN ADV ADV VERB NOUN
Bu bölgede misafir olabileceğimiz tek bir ev bile yok tu .	DET NOUN NOUN VERB ADJ DET NOUN ADV ADV AUX PUNCT
Bu beli bükük yaşlı adam aslında düşündüğünüz haklı değildi	DET NOUN ADJ ADJ NOUN ADV VERB ADJ AUX
Fransızca çalışmaktan hiç zevk almıyoru m	ADJ VERB ADV NOUN VERB NOUN
Dün akşam televizyonda çıkan filmden hiç zevk alamadı m	NOUN NOUN NOUN VERB NOUN ADV NOUN VERB NOUN
Bu kitapta ki ana karakterin babası çok itici bir insan	DET NOUN ADP ADJ NOUN NOUN ADV ADJ DET NOUN
Dün kü konser baya sıkıcı ydı	NOUN ADP NOUN ADV ADJ AUX
Sabah yaptığım yemeği sevgilim hiç beğenmedi	NOUN VERB NOUN NOUN ADV VERB
Dün arkadaşım arabası ile kaza yapmı ş	NOUN NOUN NOUN CCONJ NOUN VERB NOUN
Aldığım buzdolabı bu sabah bir anda sessizleşip bozuldu	VERB NOUN DET NOUN DET NOUN VERB VERB
Ankaranın yolları çok taşlı ymı ş	PROPN NOUN ADV ADJ AUX NOUN
Bu akşam ki planımız iptal olmu ş	DET NOUN ADP NOUN NOUN VERB NOUN
Sporda yken belimi sakatlamışım artık düzgün kalkamıyoru m	NOUN AUX NOUN VERB ADV ADJ VERB NOUN
Ödevi yaparken artık elim ağrımaya başladı	NOUN VERB ADV NOUN VERB VERB
Malesef yarın gelemeyeceğim babam hastalandı	ADV NOUN VERB NOUN VERB
Acaba bu ay sonunu getirebilecek miyim hiç bilmiyoru m	ADV DET NOUN ADJ VERB AUX ADV VERB NOUN
Venom filmi baya kötüymü ş	PROPN NOUN ADV VERB NOUN
Dün yemeği yaparken yemeği yakmışı m	NOUN NOUN VERB NOUN VERB NOUN
Artık burada yaşamak istemiyoru m	ADV NOUN VERB VERB NOUN
Koltuğa doğru yürürken masanın üzerinde ki fotoğraf dikkatimi çekti , ne kadar da tatlıymışsın !	NOUN ADP VERB NOUN NOUN ADP NOUN NOUN VERB PUNCT PRON ADP CCONJ VERB PUNCT
Dürüst olmak gerekirse benim de kalbim ona karşı boş değil .	ADJ VERB VERB PRON CCONJ ADJ PRON ADP ADJ AUX PUNCT
Kafamın içinde bu bahsettiğin konulara benzer düşünceler yok dersem yalan olur .	NOUN ADJ DET VERB NOUN VERB NOUN ADV VERB ADJ VERB PUNCT
Dün akşam babamla birlikte kovboy filmi izlerken harika vakit geçirdim .	NOUN NOUN NOUN ADP NOUN NOUN VERB ADJ NOUN VERB PUNCT
Çiçekleri genel olarak sevsem de papatyayı bir ayrı seviyorum diyebilirim .	NOUN ADJ ADP VERB CCONJ NOUN NUM ADJ VERB VERB PUNCT
Eskiden öğrenmekte zorlandığım konuyu , bu kurs sayesinde kolayca öğrenmiş oldum .	ADV VERB VERB NOUN PUNCT DET NOUN NOUN VERB VERB VERB PUNCT
Geçen cumartesi günü gittiğiniz okulun tanışma partisine çağırsaydın gelmez miydim ?	ADJ NOUN NOUN VERB NOUN VERB NOUN VERB VERB AUX PUNCT
Sesi duyup sokağa çıkan yaşlılar , iş makinesinin çalışmasını izlerken adeta büyülenmişlerdi .	NOUN VERB NOUN VERB ADJ PUNCT NOUN NOUN VERB VERB ADV VERB PUNCT
Telefon uygulamasından söylemiş olduğum yemek düşündüğümden lezzetli ydi ve hızlı gelmişti .	NOUN NOUN VERB VERB NOUN VERB ADJ AUX CCONJ ADJ VERB PUNCT
Yeni çıkan oyununu aldığı kullanıcı puanları beklenilenden çok daha iyi ydi .	ADJ VERB NOUN VERB NOUN NOUN NOUN ADV ADV ADV AUX PUNCT
Derse yetişmem için yakalamam gereken son otobüsü yakalamayı başardım ve derse yetiştim .	NOUN VERB ADP VERB VERB ADJ NOUN VERB VERB CCONJ NOUN VERB PUNCT
Yazar elinde bulundurduğu bu seriye adeta yeni bir soluk getirmiş .	NOUN NOUN VERB DET NOUN ADV ADJ DET NOUN VERB PUNCT
Elimde ki verilere baktığımda projemizi yaparken başarılı bir yolda olduğumuzu söyleyebilirim .	NOUN ADP NOUN VERB NOUN VERB ADJ DET NOUN VERB VERB PUNCT
Film şirketi , son filmi ile elinde ki markayı ne kadar doğru kullanmış .	NOUN NOUN PUNCT ADJ NOUN CCONJ NOUN ADP NOUN PRON ADP ADJ VERB PUNCT
Marka hakkı sebebiyle açılan davada kendini doğru bir şekilde savunmuş .	NOUN NOUN NOUN VERB NOUN PRON ADJ DET NOUN VERB PUNCT
Yağmur sonrası dışarıda ki o hava insanın içini ısıtıyor ve insanı mutlu ediyor .	NOUN NOUN NOUN ADP DET NOUN NOUN ADJ VERB CCONJ NOUN ADJ VERB PUNCT
Yaptığım bazı araştırmalar , beni ilgi alanım konusunda daha da motive etmiş durumda .	VERB DET VERB PUNCT PRON NOUN NOUN NOUN ADV CCONJ ADJ VERB NOUN PUNCT
Okulumuzu temsil eden takımımız bilgi yarışmasından derece ile ayrılmış bulunmakta .	NOUN NOUN VERB NOUN NOUN NOUN NOUN CCONJ VERB VERB PUNCT
Anneler günü için aldığım buketi annem çok beğendi ve beni yanağımdan öptü .	NOUN NOUN ADP VERB NOUN NOUN ADV VERB CCONJ PRON NOUN VERB PUNCT
Bugün arkadaşlarımla kafenin üst katında oynadığım oyundan fazlasıyla zevk aldım .	NOUN NOUN NOUN ADJ NOUN VERB NOUN ADV NOUN VERB PUNCT
Bir süre dir almayı beklediğim bilgisayar indirime girmiş , artık alabilirim diye düşünüyorum .	NUM NOUN AUX VERB VERB NOUN NOUN VERB PUNCT ADV VERB ADP VERB PUNCT
Uzun süre ve emek harcadığım projemin son aşamasında yım , başarmama az kaldı .	ADJ NOUN CCONJ NOUN VERB NOUN ADJ NOUN AUX PUNCT VERB ADV VERB PUNCT
Kişisel gelişim üzerine gittiğim oturum benim için fazlasıyla yararlı oldu .	ADJ NOUN NOUN VERB NOUN PRON ADP ADV ADJ VERB PUNCT
Severek takip ettiğim bir iş adamı , kariyerime etkisi olacak önem li bir yazı paylaştı .	ADV NOUN VERB DET NOUN NOUN PUNCT NOUN NOUN VERB NOUN ADP DET NOUN VERB PUNCT
Üniversite zamanı kalmak için tuttuğum evin sahibi ile tanıştım ve kendisi çok nazik biri .	NOUN NOUN VERB ADP VERB NOUN NOUN CCONJ VERB CCONJ PRON ADV ADJ PRON PUNCT
Küçük kardeşimle birlikte oyun oynarken kardeşim beni ittirdi , vazo kırıldı .	ADJ NOUN ADP NOUN VERB NOUN PRON VERB PUNCT NOUN VERB PUNCT
Dün gece yağmur yağdığı için yerler ıslanmıştı , dolayısıyla parka gidemedi m	NOUN NOUN NOUN VERB ADP NOUN VERB PUNCT ADV NOUN VERB NOUN
Bu problem çok zor görünüyor , bana sorarsan bunu öğretmen dahi çözemez .	DET NOUN ADV ADJ VERB PUNCT PRON VERB PRON NOUN ADJ VERB PUNCT
Okulun hazırladığı gösteriye , işte oldukları için ne annem ne de babam gelebildi .	NOUN VERB NOUN PUNCT ADV VERB ADP CCONJ NOUN CCONJ CCONJ NOUN VERB PUNCT
Gözlerimin içine bak ve söyle , böyle olmasını ben mi istedim ?	NOUN ADJ VERB CCONJ VERB PUNCT ADV VERB PRON AUX VERB PUNCT
Başımıza ne işler açtın sen , çık çıkabilirsen bu işin içinden .	NOUN PRON NOUN VERB PRON PUNCT VERB VERB DET NOUN ADJ PUNCT
Sabah evimden okuluma gelirken otobüste tatsız bir olayla karşılaştım .	NOUN NOUN NOUN VERB NOUN ADJ DET NOUN VERB PUNCT
Sınıfımda ki Ahmet , projelerde etkin bir rol üstlenen bir öğrenci değil .	NOUN ADP PROPN PUNCT NOUN ADJ DET NOUN VERB DET NOUN AUX PUNCT
Dayım , saatini kurmayı unuttuğu için otobüse yetişemedi ve işe geç kaldı .	NOUN PUNCT NOUN VERB VERB ADP NOUN VERB CCONJ NOUN ADV VERB PUNCT
Telefon uygulamasından söylemiş olduğum yemek , uygulamada yazan süreden geç geldi .	NOUN NOUN VERB VERB NOUN PUNCT NOUN VERB NOUN ADV VERB PUNCT
Yeni çıkan oyununu aldığı puanlar gösteriyor ki , beklentiyi karşılayamamış durumdalar .	ADJ VERB NOUN VERB NOUN VERB CCONJ PUNCT NOUN VERB NOUN PUNCT
Dediklerine bakacak olursak ağzından çıkanı kulağın duymuyor olmalı haksız mıyım ?	VERB VERB VERB NOUN NOUN NOUN VERB VERB ADJ AUX PUNCT
Telefonumun şarjı eve gidene kadar dayanamadı ve şu an kimseyi arayamıyorum .	NOUN NOUN NOUN ADV ADP VERB CCONJ DET NOUN NOUN VERB PUNCT
Yarın için olan ödevimi yaparken elektriklerin kesilmesi sebebiyle ödevimi yetiştiremeyeceğim .	NOUN ADP VERB NOUN VERB NOUN VERB NOUN NOUN VERB PUNCT
Alışveriş sitesinden siparişini verdiğim tekerlekli sandalye yine zamanında bana ulaşmayacak .	NOUN NOUN NOUN VERB ADJ NOUN ADV NOUN PRON VERB PUNCT
Çok sevdiğim bir yakın dostumla ettiğimiz tartışma sonucu birbirimize küstük .	ADJ VERB DET ADJ NOUN VERB VERB NOUN PRON VERB PUNCT
Kardeşim ders çalışırken beni sürekli rahatsız ediyor , konularımı yetiştirmekte zorlanıyorum .	NOUN NOUN VERB PRON ADV ADJ VERB PUNCT NOUN VERB VERB PUNCT
Çantamda ki su patlamış , defterlerim ıslanmış , notlarım kullanılamaz hale gelmiş durumda .	NOUN ADP NOUN VERB PUNCT NOUN VERB PUNCT NOUN VERB NOUN VERB NOUN PUNCT
Yemekhane sırasının uzunluğu sebebiyle sıra bana geldiğinde tatlı alamamış oldum .	NOUN NOUN NOUN NOUN NOUN PRON VERB ADJ VERB VERB PUNCT
Kullandığım para biriminin değer kaybetmesi sonucu almak için para biriktirdiğim gitarı alamadım .	VERB NOUN NOUN NOUN VERB NOUN VERB ADP NOUN VERB NOUN VERB PUNCT
Arkadaşımı ne kadar sevsem de güzel olmayan sesi ile şarkı söylemesi beni rahatsız ediyor .	NOUN PRON ADP VERB CCONJ ADJ VERB NOUN CCONJ NOUN VERB PRON ADJ VERB PUNCT
Sokaklarda evsiz insanları görmek beni üzüyor ve gelecek hakkında endişelendiriyor .	NOUN ADJ NOUN VERB PRON VERB CCONJ VERB NOUN VERB PUNCT
Kendisi ne kadar iyi bir insan olsa da öfke sorunları var .	PRON PRON ADP ADJ DET NOUN VERB CCONJ NOUN NOUN ADJ PUNCT
Kirasını karşılayamayacak hale geldiğim için daha düşük fiyat lı bir ev bulmalıyım .	NOUN VERB NOUN VERB ADP ADV ADJ NOUN ADP DET NOUN VERB PUNCT
Uzak mesafede oturduğum için sabah erken kalkmak fazlasıyla yorucu oluyor .	ADJ NOUN VERB ADP NOUN ADV VERB ADV ADJ VERB PUNCT
Masada ki yükseklik sorununu henüz çözememişsin .	NOUN ADP NOUN NOUN ADV VERB PUNCT
Bu aralar baya şanssızım sanırım .	DET ADJ NOUN NOUN VERB PUNCT
Bunca yoldan sonra eve nerede yse varamıyorduk .	ADJ NOUN ADP NOUN PRON AUX VERB PUNCT
Otobüse binmek beni artık pek de yormuyor .	NOUN VERB PRON ADV ADV CCONJ VERB PUNCT
Açken yemek yiyince enerjimi geri kazanıyorum .	NOUN NOUN VERB NOUN ADJ VERB PUNCT
Rahatlıkla dinlenirken nelerle karşılaşacağını bilmiyordu arkadaşımız .	NOUN VERB PRON VERB VERB NOUN PUNCT
Bir programlama dilini öğnrendikten sonra diğerlerini öğrenmek çok daha kolay geliyor .	DET NOUN NOUN VERB ADP NOUN VERB ADV ADV ADJ VERB PUNCT
Kalemimin ucunu değiştirmesi , içinde ki mekanik kısım sıkıntılı olduğundan zor oluyor .	NOUN NOUN VERB PUNCT ADJ ADP ADJ NOUN ADJ VERB ADJ VERB PUNCT
Bunca çalışma ve emekten sonra nihayet tüm derslerini geçebilmişti .	ADJ VERB CCONJ NOUN ADP ADV DET NOUN VERB PUNCT
Bilgisayarında ki temizlikten sonra cihazın performansı büyük ölçüde arttı .	NOUN ADP NOUN ADP NOUN NOUN ADJ NOUN VERB PUNCT
Gitar çalmayı çok istemişti ancak öğrenmesi ona çok zor gelmişti .	NOUN VERB ADV VERB CCONJ VERB PRON ADV ADJ VERB PUNCT
Botlarımı giyip yağmurlu havalarda yürüyüş yapmak çok sakinleştiri ci geliyor .	NOUN VERB ADJ NOUN NOUN VERB ADV NOUN ADP VERB PUNCT
Kasa bilgisayarlar daha sessiz ve soğuk olsalar da dizüstü bilgisayarları daha çok seviyorum .	NOUN NOUN ADV ADJ CCONJ ADJ VERB CCONJ ADJ NOUN ADV ADV VERB PUNCT
RGB ekipmanları sevsem de fazla ışıklar beni çok rahatsız ediyor .	NOUN NOUN VERB CCONJ ADJ NOUN PRON ADV ADJ VERB PUNCT
Bilgisayar oyunları oynamak toplumca güzel karşılanmıyor .	NOUN NOUN VERB ADV ADJ VERB PUNCT
Anladığım kadarıyla yazılımcılar , yazılımcı kimliklerini seviyor ve benimsiyorlar .	VERB NOUN ADJ PUNCT NOUN NOUN VERB CCONJ VERB PUNCT
Şirketlerin acımasız politikalarını insanlar sevmiyorlar .	NOUN ADJ NOUN NOUN VERB PUNCT
Ama yine de son çıkan pahalı ürünleri almayı herkes çok istiyor .	CCONJ ADV CCONJ ADJ VERB ADJ NOUN VERB NOUN ADV VERB PUNCT
İnsanlar sanatsal çalışmalarıın görsellik kısmını severler .	NOUN ADJ VERB ADJ NOUN VERB PUNCT
Eski dönemin kıyafetlerı sonra ki nesiller tarafından sevilmezler .	ADJ NOUN NOUN ADP ADP NOUN NOUN VERB PUNCT
Bazı insanlar fazla hareket gerektiren aktivitelere bayılıyorlar .	DET NOUN ADJ NOUN VERB NOUN VERB PUNCT
Çoğu insan yüksek mekanlarda bulunmayı güven li bulmaz .	DET NOUN ADJ NOUN VERB NOUN ADP VERB PUNCT
Dar sokaklar genelde insanlara güven vermezler .	ADJ NOUN ADV NOUN NOUN VERB PUNCT
Denizin olduğu şehirler olmadığı şehirlere göre çok daha fazla sevilir .	NOUN VERB NOUN VERB NOUN ADP ADV ADV ADV VERB PUNCT
Tır kullanmak ve yük taşımanın birçok kişi tarafından sevilir .	NOUN VERB CCONJ NOUN VERB DET NOUN NOUN VERB PUNCT
Aksiyon oyun ve filmlerinin halk nazarında kişilere kötü etkisi olduğu düşünülür .	NOUN NOUN CCONJ NOUN NOUN NOUN NOUN ADJ NOUN VERB VERB PUNCT
Kitap okumak yararlı görülse de çoğu kişi için eğlence li değildir .	NOUN VERB ADJ VERB CCONJ DET NOUN ADP NOUN ADP AUX PUNCT
Bazı romanların olayları fazla uzatması beni o romandan soğutuyor .	DET NOUN NOUN ADV VERB PRON DET NOUN VERB PUNCT
Yazılım yazdıkça alınan haz genelde artıyor .	NOUN VERB VERB NOUN ADV VERB PUNCT
Orta seviye kas bence nerede yse herkesde çok güzel görünüyor .	ADJ NOUN NOUN PRON PRON AUX NOUN ADV ADJ VERB PUNCT
Rap müziğin bu kadar popüler olmasını hiç anlamıyorum .	NOUN NOUN DET ADP ADJ VERB ADV VERB PUNCT
Küçük ama çok işlevsel alet ve cihazlara hayranım .	ADJ CCONJ ADV ADJ NOUN CCONJ NOUN VERB PUNCT
Bir yerlere giderken yavaş yürüyen insanları hiç anlayamıyorum .	DET NOUN VERB ADJ VERB NOUN ADV VERB PUNCT
Kar yağdığında kar taneleri havada ki sesi tutuyor , ve o sessizlik çok hoşuma gidiyor .	NOUN VERB NOUN NOUN NOUN ADP NOUN VERB PUNCT CCONJ DET NOUN ADV NOUN VERB PUNCT
Yemek sektöründe ki zararlı maddeleri bildikten sonra paket li yiyeceklere sıcak bakmıyorum .	NOUN NOUN ADP ADJ NOUN VERB ADP NOUN ADP NOUN ADJ VERB PUNCT
Gözlük takmak lens takmaya kıyasla çok daha iyi bana kalırsa .	NOUN VERB NOUN VERB ADJ ADV ADV ADJ PRON VERB PUNCT
Bazı angarya ödevleri yapmak beni çok sıkıyor .	DET NOUN NOUN VERB PRON ADV VERB PUNCT
Evde ki sakinlik ve rahatı başka bir şeye değişmem .	NOUN ADP NOUN CCONJ NOUN ADJ DET NOUN VERB PUNCT
Klavye ile çok hızlı yazı yazmaya bayılıyorum .	NOUN CCONJ ADV ADJ NOUN VERB VERB PUNCT
Türkçe klavyeyi kodlamada ki özel karakterleri yazması zor olduğundan sevmiyorum .	PROPN NOUN VERB ADP ADJ NOUN VERB ADJ VERB VERB PUNCT
Birçok insanın aksine çok büyük monitörler beni hiç çekmiyor .	DET NOUN ADV ADV ADJ NOUN PRON ADV VERB PUNCT
Mekanik klavyeler çok ses çıkarmasa da hissiyatlarından dolayı seviyorum .	ADJ NOUN ADV NOUN VERB CCONJ NOUN ADP VERB PUNCT
Yakın zamanda ışık hızına ulaşacak teknolojiye varabileceğimizi hiç sanmıyorum .	ADJ NOUN NOUN NOUN VERB NOUN VERB ADV VERB PUNCT
İnternet esprileri beni genelde çok güldürüyor .	NOUN NOUN PRON ADV ADV VERB PUNCT
Bilgisayarların işleyişini öğrenmek bulmaca çözmek kadar zevk veriyor .	NOUN NOUN VERB VERB VERB ADP NOUN VERB PUNCT
Temizliğine dikkat etmeyen insanları hiç anlamıyorum .	NOUN NOUN VERB NOUN ADV VERB PUNCT
Bu ödev neden hala bitmiyor anlayamıyorum .	DET NOUN PRON ADV VERB VERB PUNCT
Bu ödev bitince galiba inanılmaz mutlu olacağım .	DET NOUN VERB ADV VERB ADJ VERB PUNCT
Uğurböceği hariç çoğu böceği sevmiyorum , hatta nerede yse tiksiniyorum .	NOUN ADJ DET NOUN VERB PUNCT CCONJ PRON AUX VERB PUNCT
Sokak hayvanlarının sakin ve umursamaz bakışları çok tatlı geliyor .	NOUN NOUN ADJ CCONJ ADJ NOUN ADV ADJ VERB PUNCT
Çok uzun bir aradan sonra tekrar ata binecekleri için mutlu ydu .	ADV ADJ DET ADJ ADP ADV NOUN VERB ADP ADJ AUX PUNCT
Annemin kardeşimin doğum günü için kendi elleriyle hazırladığı pasta şahane gözüküyor .	NOUN NOUN NOUN NOUN ADP PRON NOUN VERB NOUN ADJ VERB PUNCT
Yıllar dır tuttuğu takımı canlı bir şekilde binlerce insanın arasında izlemek heyecan verici ydi .	NOUN ADP VERB NOUN ADJ DET NOUN NUM NOUN ADJ VERB NOUN VERB AUX PUNCT
Kendi ayakları üstünde durmak isteyen bir kadın olarak bu habere çok sevinmişti .	PRON NOUN ADJ VERB VERB DET ADJ ADP DET NOUN ADV VERB PUNCT
Konserde en sevdiğim sanatçıyla beraber şarkı söylerken kalbim duracak gibi ydi .	NOUN ADV VERB NOUN ADV NOUN VERB ADJ VERB ADP AUX PUNCT
İki gün önce gittiğimiz komedi programında resmen gülmekten yerlere yattık .	NUM NOUN ADP VERB NOUN NOUN ADV VERB NOUN VERB PUNCT
O küçüklüğümüzden beri hayata hep umut dolu bakan neşeli bir kızdı .	DET NOUN ADP NOUN ADV NOUN ADJ VERB ADJ DET VERB PUNCT
Küvetin içinde sıcak ve köpük lü suda vakit geçirmek iyi geldi .	NOUN ADJ ADJ CCONJ NOUN ADP NOUN NOUN VERB ADJ VERB PUNCT
Sonunda yıllarca verdiği emeğin karşılığını almış hayallari gerçek olmuştu .	ADV ADV VERB NOUN NOUN VERB NOUN ADJ VERB PUNCT
Yeni aldığı ekipmanlarını bir an önce kullanmak istiyor heyecandan yerinde duramıyordu .	ADJ VERB NOUN NUM NOUN ADP VERB VERB NOUN NOUN VERB PUNCT
Son birkaç gün dür yaşadığı pozitif olaylar onu şaşırtıyor ama mutlu ediyordu .	ADJ DET NOUN AUX VERB ADJ NOUN PRON VERB CCONJ ADJ VERB PUNCT
Zamanında ilgilendiği felç hastasının şu anda yürüyebiliyor olduğu gördüğünde mutluluktan göz yaşlarını tutamadı .	NOUN VERB NOUN NOUN DET NOUN VERB VERB VERB NOUN NOUN NOUN VERB PUNCT
Telefonunu apartmanın ikinci katından düşürmüş ama çizik dahi olmadığını görünce rahatlamıştı .	NOUN NOUN ADJ NOUN VERB CCONJ NOUN ADJ VERB VERB VERB PUNCT
Matematik testini full doğru yapan tek kişi olduğunu öğrendiğinde gururlandı .	NOUN NOUN ADV ADJ VERB ADJ NOUN VERB VERB VERB PUNCT
Babası karne hediyesi olarak çok istediği bisikletini aldığını öğrenince keyfi yerine geldi .	NOUN NOUN NOUN ADP ADV VERB NOUN VERB VERB NOUN NOUN VERB PUNCT
Havada ki fırından yeni çıkmış ekmek kokusu insanın içini huzurla dolduruyor .	NOUN ADP NOUN ADJ VERB NOUN NOUN NOUN ADJ ADV VERB PUNCT
Okulun ilk günü ilkokullu çocukların cıvıl cıvıl neşesi ve sıcak güneş li hava ile hoş bir gündü .	NOUN ADJ NOUN ADJ NOUN ADJ ADJ NOUN CCONJ ADJ NOUN ADP NOUN CCONJ ADJ DET VERB PUNCT
Uzun süre dir görmediğim babamı havalimanında bana güleryüzle bakarken görünce koşup sarıldım ona .	ADJ NOUN AUX VERB NOUN NOUN PRON NOUN VERB VERB VERB VERB PRON PUNCT
Anneannemin yaptığı çikolatalı bisküvili tatlı son zamanlarda yediğim en leziz şeydi .	NOUN VERB ADJ ADJ NOUN ADJ NOUN VERB ADV ADJ NOUN PUNCT
Bu aralar pek boş vaktim olduğundan dilediğim diziyi keyifle izleyebiliyorum .	DET ADJ ADV ADJ NOUN VERB VERB NOUN NOUN VERB PUNCT
Derbide son saniye gelen gol tüm taraftarı büyük bir sevince boğdu .	NOUN ADJ NOUN VERB NOUN DET NOUN ADJ DET NOUN VERB PUNCT
Onunla çok ortak noktamız var , sohbetlerimiz keyif li geçiyor açıkçası .	PRON ADV ADJ NOUN ADJ PUNCT NOUN NOUN ADP VERB ADV PUNCT
İki şirkette yaptıkları ortak anlaşmadan dolayı toplantıdan memnun ayrıldılar .	NUM NOUN VERB ADJ NOUN ADP NOUN ADJ VERB PUNCT
Bu tarz pozitif hayata olumlu bakan şarkılar dinlediğimde enerjim yükseliyor daha iyi hissediyorum .	DET NOUN ADJ NOUN ADJ VERB NOUN VERB NOUN VERB ADV ADJ VERB PUNCT
O gün yaşadığım en güzel gündü , doğum günü pastam , hediyeler , arkadaşlarım hepsi benim için orada ydı .	DET NOUN VERB ADV ADJ NOUN PUNCT NOUN NOUN NOUN PUNCT NOUN PUNCT NOUN PRON PRON ADP NOUN AUX PUNCT
Şehir dışında üniversite okumak için ailesinden ayrılacak olmak onu üzüyordu .	NOUN ADJ NOUN VERB ADP NOUN VERB VERB PRON VERB PUNCT
Bir süre dir planlarım yolunda gitmiyor ard arda şanssız olaylarla karşılaşıyorum .	DET NOUN AUX NOUN NOUN VERB NOUN NOUN ADJ NOUN VERB PUNCT
Sınavlardan istediği notları alamamış , emeklerinin karşılığını görmemiş olmanın burukluğu vardı üzerinde .	NOUN VERB NOUN VERB PUNCT NOUN NOUN VERB VERB NOUN VERB NOUN PUNCT
Çok küçük yaşta ailesini kaybetmiş maddi manevi zor bir çocukluk geçirmişti .	ADV ADJ ADJ NOUN VERB ADJ ADJ ADJ DET NOUN VERB PUNCT
O çocuğun kinci ve şımarık tavırlarından hoşlanmadığımı sana kaç defa söyledim .	DET NOUN ADJ CCONJ ADJ NOUN VERB PRON ADJ NOUN VERB PUNCT
Gece yarısı gençlerin sokakta ki bağrışmalarını duyan yaşlı adam sinirle homurdanarak yatağından kalktı .	NOUN ADJ ADJ NOUN ADP NOUN VERB ADJ NOUN NOUN VERB NOUN VERB PUNCT
Yarışma sonucunda ilk üçe giremeyen yarışmacı teselli ödülüne ağlayacak gibi bakıyordu .	NOUN NOUN ADJ NUM VERB NOUN NOUN NOUN VERB ADP VERB PUNCT
Karanlık ormanda ilerlerken çevreden gelen uluma sesleriyle iyice gerilmişti .	ADJ NOUN VERB NOUN VERB NOUN NOUN ADV VERB PUNCT
Saatler dir sınav kağıtlarını okumaktan yorulmuş okuma gözlüğü artık canını yakmaya başlamıştı .	NOUN AUX NOUN NOUN VERB VERB VERB NOUN ADV NOUN VERB VERB PUNCT
Bir yıldan fazla dır beslediği sokak köpeklerinin toplandığını duyduğunda hüngür hüngür ağladı .	DET NOUN ADV ADP VERB NOUN NOUN VERB VERB ADJ NOUN VERB PUNCT
Doktor covid testinin pozitif çıktığını söylediğinde kendini bir an çok kötü hissetti .	NOUN NOUN NOUN ADJ VERB VERB PRON DET NOUN ADV ADJ VERB PUNCT
Ben de bu durumdan pek memnun değilim ama elimizden bir şey gelmez .	PRON CCONJ DET NOUN ADV ADJ AUX CCONJ NOUN NUM NOUN VERB PUNCT
Düşünce dizi kanamaya başlayan çocuk acısına dayanamayıp ağlamaya başladı .	NOUN NOUN VERB VERB NOUN NOUN VERB VERB VERB PUNCT
Oynadığı kumarda son anda kaybedince kendini dünyanın en şanssız insanı ymış gibi hissetti .	VERB NOUN ADJ NOUN VERB PRON NOUN ADV ADJ NOUN AUX ADP VERB PUNCT
Otobüsü kaçırınca toplantıya yetişmek için taksiye binip fazladan para vermesi gerektiğinden sinirlenmişti .	NOUN VERB NOUN VERB ADP NOUN VERB ADV NOUN VERB VERB VERB PUNCT
Ayrı ca belirtmeliyim ki ülke ekonomimizin bu kadar kötü olması beni de üzmüyor değil .	ADJ ADP VERB CCONJ NOUN NOUN DET ADP ADJ VERB PRON CCONJ VERB AUX PUNCT
Yeğenimin gece köpek saldırısına uğraması ailede ki herkesin keyfini kaçırdı .	NOUN NOUN NOUN NOUN VERB NOUN ADP NOUN NOUN VERB PUNCT
Evin tadilat işlerinin birkaç gün daha süreceğini öğrenince yüzü düştü .	NOUN NOUN NOUN DET NOUN ADV VERB VERB NOUN VERB PUNCT
Bu tarz olayları bu kadar sık yaşamak onu yormuş ve bıktırmıştı hayattan .	DET NOUN NOUN PRON ADP ADV VERB PRON VERB CCONJ VERB NOUN PUNCT
Bir anda hızla geçen motor küçük çocuğu korkutmuş ve ağlamasına sebep olmuştu .	DET NOUN NOUN VERB NOUN ADJ NOUN VERB CCONJ VERB NOUN VERB PUNCT
Eşyalar taşınırken ailenin küçük çocuğunun klavyesi kırılmış suratı beş karıştı .	NOUN VERB NOUN ADJ NOUN NOUN VERB NOUN NUM VERB PUNCT
Yorucu günden sonra koltukta uyuyakalmış gördüğü kabusun etkisiyle ter içinde çığlıkla uyandı .	ADJ NOUN ADP NOUN VERB VERB NOUN NOUN NOUN ADJ ADV VERB PUNCT
Bir önce ki işinde geçirdiği zor zamanlar onda derin yaralar bırakmış .	NUM NOUN ADP NOUN VERB ADJ NOUN PRON ADJ NOUN VERB PUNCT
Verdiğim siparişin geç gelmesi yetmezmiş gibi gelen yemekler birbirine karışmış ve soğumuştu .	VERB NOUN ADV VERB VERB ADP VERB NOUN PRON VERB CCONJ VERB PUNCT
Bir buçuk yıl dır üniversite sınavına hazırlanıyor olmasına rağmen kendiniz hazır hissetmiyor .	NUM NUM NOUN ADP NOUN NOUN VERB VERB ADP PRON ADJ VERB PUNCT
Bazı insanların hala makineleşmemiş olması beni mutlu ediyor .	DET NOUN ADV VERB VERB PRON ADJ VERB PUNCT
Bu pis dünyada insan görmemiş ormanların güzelliği güneşin doğmasını sağlıyor .	DET ADJ NOUN NOUN VERB NOUN NOUN NOUN VERB VERB PUNCT
Siyah beyaz dünyama rangarenk gökkuşakları getiren yol arkadaşımla evleneceğim .	ADJ ADJ NOUN ADJ NOUN VERB NOUN NOUN VERB PUNCT
Bir çocuğun anne sevgisi gibi ydi benim sevgim , hiç bitmezcesine .	DET NOUN NOUN NOUN ADP AUX PRON NOUN PUNCT ADV VERB PUNCT
Önümüzde ki aydan itibaren % 25 zam alacağım için çok mutlu yum .	ADJ ADP NOUN ADP NUM NUM NOUN VERB ADP ADV ADJ AUX PUNCT
İnsanların toplumsal yerine bireysel farkındalıklarını keşfetmeleri sevindirici bir gelişme	NOUN ADJ NOUN ADJ NOUN VERB ADJ DET VERB
Kadın ile erkekler elbette eşit değiller , erkeklerin böyle muhteşem varlıklara karşı hiç şansı yok	ADJ CCONJ ADJ ADV ADJ AUX PUNCT ADJ ADV ADJ ADJ ADP DET NOUN ADJ
Bana verilen bu hayatı seninle paylaştığım için minnettarım .	PRON VERB DET NOUN PRON VERB ADP NOUN PUNCT
Halamın yaptığı Afrika örgüsüne resmen bayıldım , sırada dövme var .	NOUN VERB PROPN NOUN ADV VERB PUNCT NOUN NOUN ADJ PUNCT
Öyle güzel gözleri var ki orda kayboluyorum , tüm dünya blurlanmış ve tek gördüğüm o gözler .	ADV ADJ NOUN ADJ CCONJ NOUN VERB PUNCT DET NOUN VERB CCONJ ADJ VERB DET NOUN PUNCT
Bahçemizde ki dişi köpek bu sabah doğum yaptı , yavruları çok tatlılar .	NOUN ADP NOUN NOUN DET NOUN NOUN VERB PUNCT NOUN ADJ NOUN PUNCT
Bu devirde Rover ' dan anlayan eli düzgün bir usta bulmak büyük nimet .	DET NOUN PROPN PUNCT ADP VERB NOUN ADJ DET NOUN VERB ADJ NOUN PUNCT
Bir hayalim var gözlerinde saklı , her an aklımdasın ceylan gözlüm .	DET NOUN ADJ NOUN ADJ PUNCT DET NOUN VERB NOUN NOUN PUNCT
Yazdığım kitabın bu genç arkadaşıma yol göstermesi kadar güzel bir his yok şu anda .	VERB NOUN DET ADJ NOUN NOUN VERB ADP ADJ DET NOUN ADJ DET NOUN PUNCT
İstanbul demek ha , böyle bir güzellik için yazılanlar yetersiz bile .	PROPN VERB INTJ PUNCT ADJ DET NOUN ADP NOUN ADJ ADV PUNCT
Bu yıl yapılmasını beklediğim motor festivali şehrimde yapılacak .	DET NOUN VERB VERB NOUN NOUN NOUN VERB PUNCT
Bu yıl yapılan bilek güreşi turnuvasını 2 . olarak tamamladım ve Avrupa turnuvasına hak kazandım .	DET NOUN VERB NOUN NOUN NOUN NUM PUNCT ADP VERB CCONJ PROPN NOUN NOUN VERB PUNCT
Zamanında yaptığım fedakarlıklar karşılıklarını vermeye başladılar .	NOUN VERB NOUN NOUN VERB VERB PUNCT
Yaptırdığım dövmeleri çevremde ki herkes çok beğendiğini söyledi .	VERB NOUN NOUN ADP NOUN ADV VERB VERB PUNCT
Pazartesi günü benimle kulübe gelmeyi kabul etti .	NOUN NOUN PRON NOUN VERB NOUN VERB PUNCT
Kayınpederim kızına olan sevgim ve saygımdan ötürü bana şirket hisselerinden pay verdi .	NOUN ADJ VERB NOUN CCONJ NOUN ADP PRON NOUN NOUN NOUN VERB PUNCT
Sonunda hep düşlediğim tekneyi artık bu ay gidip alacağım .	ADV ADV VERB NOUN ADV DET NOUN VERB VERB PUNCT
Son yapılan transferler sayesinde taraftarın sevgisini tekrar kazandık .	ADJ VERB NOUN NOUN NOUN NOUN ADV VERB PUNCT
Bugün dostlarım en sevdiğim masa oyunu olan 101 ' e davet ettiler beni .	NOUN NOUN ADV VERB NOUN NOUN VERB NUM PUNCT ADP NOUN VERB PRON PUNCT
Çiçekçiden aldığım laleleri eşim çok beğendi çünkü en çok sarı rengini sevdiğini biliyordum .	NOUN VERB NOUN NOUN ADV VERB CCONJ ADV ADJ ADJ NOUN VERB VERB PUNCT
Onun yaşamının yokuş aşağı gittiği yıl , benim ki de yokuş aşağı gittti .	PRON NOUN NOUN ADJ VERB NOUN PUNCT PRON CCONJ CCONJ NOUN ADJ VERB PUNCT
21 yaşımda canlılığımın tükenmişliğinde , hala yaşıyorum ama üç adım önümü göremiyorum .	NUM ADJ NOUN NOUN PUNCT ADV VERB CCONJ NUM NOUN ADJ VERB PUNCT
Yaşamımın en güneşsiz kışını da İstanbul ' da ses siz bir gölge olarak geçirdim .	NOUN ADV ADJ NOUN CCONJ PROPN PUNCT CCONJ NOUN ADP DET NOUN ADP VERB PUNCT
Kaç yaşında olduğumuz önemsiz ancak yaşlılığın iyi bir şey olduğunu da söyleyemem .	NUM NOUN VERB ADJ CCONJ NOUN ADJ NUM NOUN VERB CCONJ VERB PUNCT
İstisnası olmaya heves ettiğiniz işler yüzünden bu durumda yız !	NOUN VERB NOUN VERB NOUN NOUN DET NOUN AUX PUNCT
Kadın erkek erdemlerine sahipse kaçıp gitmeli ondan .	ADJ ADJ NOUN VERB VERB VERB PRON PUNCT
Vefatından sonra çok denedim yaşamayı , olmadı kendimi kandırmışım sadece .	NOUN ADP ADV VERB VERB PUNCT VERB PRON VERB ADV PUNCT
O kasım gecesi iyi ki seninle birlikte yağmurda ıslanmışız ( ! )	DET NOUN NOUN ADJ CCONJ PRON ADP NOUN VERB PUNCT PUNCT PUNCT
Bahçemin halinden baharımı kıyasla , ben artık çiçekleri sevemiyorum .	NOUN NOUN NOUN VERB PUNCT PRON ADV NOUN VERB PUNCT
Ne safmışım ! Seni bırakmam demişti , kendisi devirdi ve gitti .	PRON VERB PUNCT PRON VERB VERB PUNCT PRON VERB CCONJ VERB PUNCT
Bir gün ne de olsa bırakırım demiştim , artık kokain bağımlısıyım .	DET NOUN PRON CCONJ VERB VERB VERB PUNCT ADV NOUN VERB PUNCT
Bu kanunlar istemiyor temiz kalsın herkes , kirlenmiş bir dünyada yız .	DET NOUN VERB ADJ VERB NOUN PUNCT VERB DET NOUN AUX PUNCT
Söz vermiştin her Pazar o bankta oturacaktık , ben hep bekledim seni umutsuzca .	NOUN VERB DET NOUN DET NOUN VERB PUNCT PRON ADV VERB PRON ADV PUNCT
Beni umursuyormuş ( ! ) Bir gece odasında boş ilaç kutusu ve bir oda polisle uğurladım .	PRON VERB PUNCT PUNCT PUNCT DET NOUN NOUN ADJ NOUN NOUN CCONJ NUM NOUN NOUN VERB PUNCT
Benim sonbaharımda ağaçlar yaprak dökmüyor , bir ilmek sallanıyor sadece .	PRON NOUN NOUN NOUN VERB PUNCT DET NOUN VERB ADV PUNCT
Yeni uygulanan zamlardan sonra güncel fiyatlara göre alabileceğim bir araç yok .	ADJ VERB NOUN ADP ADJ NOUN ADP VERB DET NOUN ADJ PUNCT
Bu ay öngörü süz harcamalar sonucunda pazarda gerilememiz kaçınılmaz .	DET NOUN NOUN ADP VERB NOUN NOUN VERB VERB PUNCT
Öğrendim ki en sevdiğim dizi " You " 3 . sezonda hikaye değişikliğine başvurrmuş .	VERB CCONJ ADV VERB NOUN PUNCT PROPN PUNCT NUM ADJ NOUN NOUN NOUN VERB PUNCT
Bir gün son sarılmamız olacak ama bunu hiçbir zaman anlayamayacağız .	DET NOUN ADJ VERB VERB CCONJ PRON DET NOUN VERB PUNCT
Bir anda burnum kanamaya başladığı için sınavı yarım bırakmak zorunda kaldım .	DET NOUN NOUN VERB VERB ADP NOUN ADJ VERB ADJ VERB PUNCT
Babam ben küçükken kolumda sigara söndürdüğü için , koluma dokunulmasından hoşlanmıyorum .	NOUN PRON ADV NOUN NOUN VERB ADP PUNCT NOUN VERB VERB PUNCT
Babamı hiç sevemedim çünkü her zaman döverdi , hiç sevmezdi .	NOUN ADV VERB CCONJ DET NOUN VERB PUNCT ADV VERB PUNCT
Bu sezon şampiyonluk hayalimiz gerçek olamayacak arkadaşlar .	DET NOUN NOUN NOUN ADJ VERB NOUN PUNCT
Çok severek izlediğim dizinin son 3 bölümü kaldı sadece .	ADV ADV VERB NOUN ADJ NUM NOUN VERB ADV PUNCT
Komşuların dediğine göre annem öldükten sonra hiç tanınmaz biri olmuşum çevreme .	ADJ VERB ADP NOUN VERB ADP ADV VERB PRON VERB NOUN PUNCT
Dün akşam izlediğim film aslında çok da fena değildi .	NOUN NOUN VERB NOUN ADV ADV CCONJ ADJ AUX PUNCT
Büyük Ev Ablukada grubu dün Bursada konser verdi ve konser eğlenceli ydi .	ADJ NOUN PROPN NOUN NOUN PROPN NOUN VERB CCONJ NOUN ADJ AUX PUNCT
Arif Bey bugün kü vardiyası bittiği için sevindi ve şu an çok mutlu .	PROPN NOUN NOUN ADP NOUN VERB ADP VERB CCONJ DET NOUN ADV ADJ PUNCT
Geçen hafta vizyona giren Dune filmi izleyiciler tarafından çok beğenildi .	ADJ NOUN NOUN VERB PROPN NOUN NOUN NOUN ADV VERB PUNCT
Yolda yürürken yerde 1 TL buldum . Kumbaramda artık 6 , 5 TL var . Zengin oldum .	NOUN VERB NOUN NUM NOUN VERB PUNCT NOUN ADV NUM PUNCT NUM NOUN ADJ PUNCT ADJ VERB PUNCT
Aynanın karşısına geçtiğimde gördüğüm kişinin çok yakışıklı olduğunu düşünüyorum .	NOUN ADJ VERB VERB NOUN ADV ADJ VERB VERB PUNCT
Bugün dışarıya çıkarken bot giydiğim için ayaklarım ıslanmadı ve sıcak kaldı .	NOUN NOUN VERB NOUN VERB ADP NOUN VERB CCONJ ADJ VERB PUNCT
Eylülün başında yapılan teorik ehliyet sınavını büyük bir başarıyla tamamladım .	NOUN NOUN VERB ADJ NOUN NOUN ADJ DET NOUN VERB PUNCT
Ayakkabı fiyatları çok pahalı ama indirim kuponu bulduğum için ucuza geldi ve param cebimde kaldı .	NOUN NOUN ADV ADJ CCONJ NOUN NOUN VERB ADP ADJ VERB CCONJ NOUN NOUN VERB PUNCT
Onca yıldan sonra geldiğim yerden ve olduğum kişiden çok memnunum .	DET NOUN ADP VERB NOUN CCONJ VERB NOUN ADV VERB PUNCT
Küçükken legolarımda ve oyuncaklarımla oynarken ki anılarımı çok seviyorum .	NOUN NOUN CCONJ NOUN VERB ADP NOUN ADV VERB PUNCT
Karanlıkta gürleyen şelalenin içime huzur doldurması ben fazlasıyla mest ediyor .	NOUN VERB NOUN ADJ NOUN VERB PRON ADV NOUN VERB PUNCT
Sinema biletimi internetten aldığım için mısır menüsünde yüzde yirmi indirim kuponu kazandım .	NOUN NOUN NOUN VERB ADP NOUN NOUN NUM NUM NOUN NOUN VERB PUNCT
Kendimi tutacağım , çok sabırlı olacağım . Ne yapıp edip sonunda üstesinden geleceğim .	PRON VERB PUNCT ADJ ADJ VERB PUNCT PRON VERB VERB ADV ADJ VERB PUNCT
Yarın gireceğim film üç boyut lu olduğu için gözlüklerimi aldım ve film için heyecan lıyım .	NOUN VERB NOUN NUM NOUN ADP VERB ADP NOUN VERB CCONJ NOUN ADP NOUN AUX PUNCT
Bana aynısından oldu , hiçbir şey olmuyor . Ertesi gün yine eskisi gibi mutlu ydum .	PRON NOUN VERB PUNCT DET NOUN VERB PUNCT ADJ NOUN ADV ADJ ADP ADJ AUX PUNCT
Yaptığım yatırımlar yakında değerlenecek ve bir anda çok zengin birisi olacağı m	VERB NOUN ADJ VERB CCONJ DET NOUN ADV ADJ PRON VERB NOUN
Geçen gün altın aldım ve ertesi gün altın yükseldi . Kısa günün kârı yine para kazandım .	ADJ NOUN NOUN VERB CCONJ ADJ NOUN ADJ VERB PUNCT ADJ NOUN NOUN ADV NOUN VERB PUNCT
Bugün hava yağmurlu olmasına rağmen otobüs zamanında geldi ve işe geç kalmadığım için yöneticim beni tebrik etti .	NOUN NOUN ADJ VERB ADP NOUN NOUN VERB CCONJ NOUN ADV VERB ADP NOUN PRON NOUN VERB PUNCT
Yolda gelirken birisi piyano çalıyordu . Çok sevdiğim bir animenin müziği ydi . Bu yüzden fazlasıyla mest oldum .	NOUN VERB PRON NOUN VERB PUNCT ADJ VERB DET NOUN NOUN AUX PUNCT DET NOUN ADV NOUN VERB PUNCT
Yakın zamanda bir bağlama kursu var dı . Ona katıldım ve artık bağlama çalabiliyorum .	ADJ NOUN DET NOUN NOUN ADJ AUX PUNCT PRON VERB CCONJ ADV VERB VERB PUNCT
Adam kendini bir turşuya dönüştürdü ! Bu gerçekten ama gerçekten aşırı komik bir olay !	NOUN PRON DET NOUN VERB PUNCT PRON ADV CCONJ ADV ADJ ADJ DET NOUN PUNCT
Şimdi sallama zamanı diyerekten ödevim için 75 tane cümleyi yazdım ve şu anlık ödevimi bitirdim .	ADV VERB NOUN NOUN NOUN ADP NUM NOUN NOUN VERB CCONJ DET NOUN NOUN VERB PUNCT
Dün akşam gittiğim konser kafamı dağıttı ve beni fazlasıyla mutlu etti .	NOUN NOUN VERB NOUN NOUN VERB CCONJ PRON ADV ADJ VERB PUNCT
Kendimi bildim bileli insanlarla iletişim kurma konusunda normalden bir tık fazla becerik li yim .	PRON VERB ADV NOUN NOUN VERB NOUN NOUN DET NOUN ADV NOUN ADP AUX PUNCT
Yahu o kadar mesaimiz var biriniz bile çıkıp nereye gidiyorsun demedi . Hepinize yazıklar olsun .	INTJ DET ADP NOUN VERB AUX ADV VERB PRON VERB VERB PUNCT NOUN NOUN VERB PUNCT
Kendini ölümün sessiz huzuruna teslim eden Martin Eden artık bu dünada değil .	PRON NOUN ADJ NOUN NOUN VERB PROPN VERB ADV DET NOUN AUX PUNCT
Peşimi bırakmıyor bu yükselişlerim . İhtimallerin heyecanına üzülüyorum elimde değil .	NOUN VERB DET NOUN PUNCT NOUN NOUN VERB NOUN AUX PUNCT
İşler uzadığı için ve sürekli aksilikler çıktığı için bu gece işten erken çıkamadık .	NOUN VERB ADP CCONJ ADV NOUN VERB ADP DET NOUN NOUN ADV VERB PUNCT
Bugün işe gelirken kuzenimin verdiği çok sevdiğim bir bilekliği kaybettim . Bu beni ziyadesiyle üzdü .	NOUN NOUN VERB NOUN VERB ADJ VERB DET NOUN VERB PUNCT PRON PRON NOUN VERB PUNCT
Ne kadar mutluyduk oysa dünya şahidim . Her şey dünyaya ait ve ben bu dünyayı sevmedim .	PRON ADP VERB CCONJ NOUN NOUN PUNCT DET NOUN NOUN ADP CCONJ PRON DET NOUN VERB PUNCT
Bana bir baktı , beni bir gördü , beni bir süzdü , bana sokuldu ama sonradan beni beğenmedi .	PRON ADV VERB PUNCT PRON ADV VERB PUNCT PRON ADV VERB PUNCT PRON VERB CCONJ ADV PRON VERB PUNCT
Bak halime kül oldum uçtum gittim . Şu ana kadar en çok üzüldüğüm olay bu oldu .	VERB NOUN NOUN VERB VERB VERB PUNCT DET NOUN ADP ADV ADV VERB NOUN PRON VERB PUNCT
Bugün bir ok ile vuruldum ve yaramı dezenfekte edip sarmadığım için mikrop kaptı .	NOUN DET NOUN CCONJ VERB CCONJ NOUN NOUN VERB VERB ADP NOUN VERB PUNCT
Bedenim özgür kalsa neye yarar . İçimde kalanlar ruhumu her gün daha fazla acıtır .	NOUN ADJ VERB PRON VERB PUNCT ADJ NOUN NOUN DET NOUN ADV ADV VERB PUNCT
Gün geçtikçe masadan eksiliyor dostlar . Yalnız kalma korkusuyla huzursuz oluyorum .	NOUN VERB NOUN VERB ADJ PUNCT ADV VERB NOUN ADJ VERB PUNCT
Bursada işlek bir yolda giderken hatalı sollama yaptığım için bir kaza yaptım .	PROPN ADJ DET NOUN VERB ADJ VERB VERB ADP DET NOUN VERB PUNCT
Araba ile yolda giderken benzin bitti ve in cin top oynayan yerde yolda kaldık .	NOUN CCONJ NOUN VERB NOUN VERB CCONJ NOUN NOUN NOUN VERB NOUN NOUN VERB PUNCT
Yakınlarda bir gezegende unuttuğum tüm şeyler hepsi ayrı bir anı çağırıp beni üzüyor .	NOUN DET NOUN VERB DET NOUN PRON ADJ DET NOUN VERB PRON VERB PUNCT
Gece güzel ama mahvetmek üzereyim yalan yok , hepinizi üzmek istiyorum .	NOUN ADJ CCONJ VERB VERB ADJ ADV PUNCT PRON VERB VERB PUNCT
Bir şehre ait olmak çok zor dur . Sürekli oradan oraya koşturduğumuz için hiç sevilmemişiz .	DET NOUN ADP VERB ADJ ADJ AUX PUNCT ADV NOUN NOUN VERB ADP ADV VERB PUNCT
Evde ki gazania türü çiçeğim sulamasını unuttuğum ve böcek ilacı sıkmadığım için solmuş .	NOUN ADP NOUN NOUN NOUN NOUN VERB CCONJ NOUN NOUN VERB ADP VERB PUNCT
Çocukken beni tam parmağımın ucundan arı sokmuştu canım muazzam yanmıştı .	ADV PRON ADV NOUN NOUN ADJ VERB NOUN NOUN VERB PUNCT
Ne kaldı bak ellerimde , biliyorum gülüyorsun . Her adımım daha derine , ölüyorum .	PRON VERB VERB NOUN PUNCT VERB VERB PUNCT DET NOUN ADV ADJ PUNCT VERB PUNCT
Rüzgargülleri temiz enerji üretimi konusunda fayda lı ama kuşların göç yolunda olduğu için binlerce kuşu öldürüyor .	NOUN ADJ NOUN NOUN NOUN NOUN ADP CCONJ NOUN NOUN NOUN VERB ADP NUM NOUN VERB PUNCT
Bu sabahların bir anlamı olmadığı için günlerim bomboş geçiyor ve verim alamıyorum .	DET NOUN DET NOUN VERB ADP NOUN ADJ VERB CCONJ NOUN VERB PUNCT
Marmara denizinde ki müsilaj sorunu bu seneki balık fiyatlarını etkiledi ve artık eskisi kadar balık yiyemiyoruz .	PROPN NOUN ADP NOUN NOUN DET NOUN ADJ NOUN VERB CCONJ ADV ADJ ADP ADJ VERB PUNCT
Büyük Ev Ablukada konserinde solistin şiir okuduğu bir kısımda seyircilerden birisi alkış tuttu . Rezalet bir andı .	ADJ NOUN NOUN NOUN NOUN NOUN VERB DET NOUN NOUN PRON NOUN VERB PUNCT ADJ DET VERB PUNCT
Dün akşam soğuk havada ince giyindiğim için üşütmüşüm ve ertesi gün hasta oldum .	NOUN NOUN ADJ NOUN ADJ VERB ADP VERB CCONJ ADJ NOUN ADJ VERB PUNCT
Yapılan bir operasyon sonucunda bir amerikan askeri mayına basarak sağ ayağını kaybetmiş .	VERB DET NOUN NOUN DET ADJ ADJ NOUN VERB ADJ NOUN VERB PUNCT
Haluk öğretmen işini seven , ciddi , öğreten bir insan dır .	PROPN NOUN NOUN VERB PUNCT ADJ PUNCT VERB DET NOUN AUX PUNCT
Antakya belediyesi çok medeni imiş o zamanlar .	PROPN NOUN ADV ADJ AUX DET NOUN PUNCT
Gözler gülümsüyorsa muhtemelen kağıtlar iyi gelmiştir .	NOUN VERB ADV NOUN ADJ VERB PUNCT
Ahmet Hocanın verdiği bu haber , bütün sınıfı sevince boğdu .	PROPN PROPN VERB DET NOUN PUNCT ADJ NOUN NOUN VERB PUNCT
Bahçe binbir çeşit çiçekle bezenmiş , rengarenk olmuş , güzel kokularla dolmuştu .	NOUN NUM NOUN NOUN VERB PUNCT ADJ VERB PUNCT ADJ NOUN VERB PUNCT
Bu dayanılmaz güzelliğe , sese nasıl hayır diyebilirdim bilmiyorum .	DET VERB NOUN PUNCT NOUN ADV NOUN VERB VERB PUNCT
Yetenekli , özgür ve zengin yapılı insanlar hayatta her zaman en önden gidenler dir .	ADJ PUNCT ADJ CCONJ ADJ ADJ NOUN NOUN DET NOUN ADV ADJ ADJ AUX PUNCT
Hisselerin tavan yapması bir çok insanı zengin etti .	NOUN NOUN VERB DET ADJ NOUN ADJ VERB PUNCT
Vadi Siteleri size konforlu bir hayat sunuyor .	NOUN NOUN PRON ADJ DET NOUN VERB PUNCT
Kapıdan çıkıtğı anda ayağı takıldı , fakat arkasından onu nazikçe tutan bir el , onu bu kötü durumdan daha içine girmeden kurtardı .	NOUN VERB NOUN NOUN VERB PUNCT CCONJ ADJ PRON NOUN VERB DET NOUN PUNCT PRON DET ADJ NOUN ADV ADJ VERB VERB PUNCT
Fatma nine karşı dairede yaşayan yumuşak huylu , melek gibi bir kadındı .	PROPN NOUN ADP NOUN VERB ADJ ADJ PUNCT NOUN ADP DET VERB PUNCT
Sosyal medya platformlarında yaptığı birçok başarısız girişimin sonucunda büyük bir başarı yakaladı .	ADJ NOUN NOUN VERB DET ADJ NOUN NOUN ADJ DET NOUN VERB PUNCT
Fiyatı çok yüksek olmasına rağmen binlerce kullanıcı bu ürünü hevesle satın alıyor .	NOUN ADV ADJ VERB ADP NUM NOUN DET NOUN ADV ADV VERB PUNCT
Paylaşacak pek bir şeyi olmasa da arkadaş gruplarıyla takılmak onu çok mutlu eder .	VERB ADV DET NOUN VERB CCONJ NOUN NOUN VERB PRON ADV ADJ VERB PUNCT
Günümüzde bilgisayar teknolojisi hızla gelişmeye ve yaygınlaşmaya devam ediyor .	NOUN NOUN NOUN NOUN VERB CCONJ VERB NOUN VERB PUNCT
Çok hasta ydı fakat annesini her görüşünde içi ısınır , yumuşak bir gülümseme yerleştirirdi yüzüne .	ADV ADJ AUX CCONJ NOUN DET NOUN ADJ VERB PUNCT ADJ DET NOUN VERB NOUN PUNCT
Camının önünde duran onlarca çiçeği sulamak ruhunu dinlendiriyordu .	NOUN ADJ VERB NUM NOUN VERB NOUN VERB PUNCT
Hayati fonksiyonlarında ciddi bir yükseliş görmek doktoru heyecanlandırdı .	NOUN NOUN ADJ DET NOUN VERB NOUN VERB PUNCT
Her hafta okuluna aksatmadan gider , inci gibi notlar tutardı .	DET NOUN NOUN VERB VERB PUNCT NOUN ADP NOUN VERB PUNCT
Aldığı iyi terbiye yüzüne vurmuş , bakımlı ve yakışıklı bir çocuk yardım etti kalkmasına .	VERB ADJ NOUN NOUN VERB PUNCT ADJ CCONJ ADJ DET NOUN NOUN VERB VERB PUNCT
Aldığı ilaçlar baş ağrısını dindiriyor ve daha rahat çalışmasını sağlıyordu .	VERB NOUN NOUN NOUN VERB CCONJ ADV ADJ VERB VERB PUNCT
Maharet li ellerinin dokunduğu bütün yemekler lezzet pınarlarına dönüşüyor .	NOUN ADP NOUN VERB ADJ NOUN NOUN NOUN VERB PUNCT
Müziğin ilk notalarında kendini kaybediyor , büyük bir zevkle dans etmeye başlıyor .	NOUN ADJ NOUN PRON VERB PUNCT ADJ DET NOUN NOUN VERB VERB PUNCT
Açıklamaların mantık çerçevesinde yapılması herkesi rahatlatmıştı .	NOUN NOUN NOUN VERB NOUN VERB PUNCT
Bütün her şeyi bir kenara bırakıp sakin bir sahil kasabasına yerleşmeyi başardı sonunda .	ADJ DET NOUN DET ADJ VERB ADJ DET NOUN NOUN VERB VERB ADV PUNCT
Fabrika sayısının kontrolsüz artması sonucu arazi kirlenmesi ve tahribat başladı .	NOUN NOUN ADJ VERB NOUN NOUN VERB CCONJ NOUN VERB PUNCT
Suç ilanları ve kayıp haberleri dışında başka bir şey göremiyorum ben .	NOUN NOUN CCONJ NOUN NOUN ADJ ADJ NUM NOUN VERB PRON PUNCT
İşte makinelerin kapitalist kullanımının muhteşem sonucu !	ADV NOUN NOUN NOUN ADJ NOUN PUNCT
Evlatlarını kaybetmenin dayanılmaz acısı ile ağıtlar yakıyor , kendini yerden yere vuruyor .	NOUN VERB VERB ADJ CCONJ NOUN VERB PUNCT PRON NOUN NOUN VERB PUNCT
Shift tuşları bozuk olduğu için bu işaretleri yazamıyor , raporu gönderemiyorlardı .	NOUN NOUN ADJ VERB ADP DET NOUN VERB PUNCT NOUN VERB PUNCT
Kitapların hepsini yakıyorlar , insanları köleleştiriyorlar ve eskiyi unutmaları için inanılmaz psikolojik işkenceler uyguluyorlardı .	NOUN PRON VERB PUNCT NOUN VERB CCONJ ADJ VERB ADP VERB ADJ NOUN VERB PUNCT
Avukatlar ve hukukçular da aynı büyük , ani ve hain cezaya çarptırılacaklar .	NOUN CCONJ NOUN CCONJ ADJ ADJ PUNCT ADJ CCONJ ADJ NOUN VERB PUNCT
Yalnızca her türlü kişisel farkındalığın dışlandığı düşüncelere saldırırım .	ADV DET ADJ ADJ NOUN VERB NOUN VERB PUNCT
Kibrit çöpü gibi kolları , bardağı kaldırmaktan bile acizdi .	NOUN NOUN ADP NOUN PUNCT NOUN VERB ADV VERB PUNCT
Kendi bölümü hakkında şaşırtıcı derecede az fikre sahipti .	PRON NOUN NOUN ADJ NOUN ADJ NOUN VERB PUNCT
Bunlar bir iki yıllığına ABD ' ye gidiyor , dönerken beraberlerinde orda gördükleri yalan yanlış şeyleri beraberlerinde getiriyorlardı .	PRON NUM NUM NOUN NOUN PUNCT ADP VERB PUNCT VERB NOUN NOUN VERB ADJ ADJ NOUN NOUN VERB PUNCT
Bu yaptığın hareket hiç hoş değil .	DET VERB NOUN ADV ADJ AUX PUNCT
Bu kadar hızlı gelişen bir teknolojinin duvarları arasında tıkılıp kalan çocuklar , sosyallikten mahrum bir şekilde büyüyor .	DET ADP ADJ VERB DET NOUN NOUN ADJ VERB VERB NOUN PUNCT NOUN ADJ DET NOUN VERB PUNCT
Yapılan bütün müdahalelere rağmen hayata gözlerini yumdu .	VERB ADJ NOUN ADP NOUN NOUN VERB PUNCT
Defalarca enstruman değiştirmesine , farklı kurslara gitmesine ve saatlerce uğraşmasına rağmen müzikte başarı yakalayamadı .	ADV NOUN VERB PUNCT ADJ NOUN VERB CCONJ ADV VERB ADP NOUN NOUN VERB PUNCT
Birbirini ezdi insanlar , yumruk kadar simsiyah bir somun ekmek için .	PRON VERB NOUN PUNCT NOUN ADP ADJ DET NOUN VERB ADP PUNCT
Bir avuç para için yapılacak iş mi bu Allah aşkına !	NUM NOUN NOUN ADP VERB NOUN AUX DET PROPN NOUN PUNCT
Ey burjuvazinin devrimci ilkelerinin uğradığı içler acısı başarısızlık !	INTJ NOUN ADJ NOUN VERB NOUN ADJ NOUN PUNCT
Gün geçtikçe artar oldu derdim demiştim ; üzülmesin öldüğünde geçer demişsin .	NOUN VERB VERB VERB VERB VERB PUNCT VERB VERB VERB VERB PUNCT
Öldüğünde çocuklarına üç kuruş bırakamadı , göçtü gitti .	VERB NOUN NUM NOUN VERB PUNCT VERB VERB PUNCT
Her adım atmaya çalıştığımda bileğimde ki acı daha da artıyor gözümden yaş geliyordu .	DET NOUN VERB VERB NOUN ADP ADJ ADV CCONJ VERB NOUN ADJ VERB PUNCT
Yırtık elbiselerle Ankara soğuğunda ayağı çıplak geziyor , mendil satmaya çalışıyordu .	ADJ NOUN PROPN NOUN NOUN ADJ VERB PUNCT NOUN VERB VERB PUNCT
Ustanın yaptığı bütün fayansları tek tek kırıp suratına bağırdı .	NOUN VERB ADJ NOUN ADJ ADJ VERB NOUN VERB PUNCT
Soğuk bir sesle ortamı terketmemi yok sa çok kötü şeyler yaşanacağını söyledi .	ADJ DET ADV NOUN VERB ADJ AUX ADV ADJ NOUN VERB VERB PUNCT
At merakı , attan düşüp belini kırmasıyla son buldu .	NOUN NOUN PUNCT NOUN VERB NOUN VERB ADJ VERB PUNCT
Yeni oda arkadaşımın bilgisayarını seviyoru m	ADJ NOUN NOUN NOUN VERB NOUN
Yurt odamızın duvarlarında ki rengi çok beğeniyoru m	NOUN NOUN NOUN ADP NOUN ADV VERB NOUN
Müşteriler yeni kampanya için çok heyecanlı	NOUN ADJ NOUN ADP ADV ADJ
Çocuk parka gideceği için çok hevesli ydi	NOUN NOUN VERB ADP ADV ADJ AUX
Çok istediğim kitap indirime girmi ş	ADV VERB NOUN NOUN VERB NOUN
Ona bakarken gözünün içi parlıyordu	PRON VERB NOUN ADJ VERB
Sevgilimle romantik bir akşam yemeği yedi k	NOUN ADJ DET NOUN NOUN VERB NOUN
Kızımın geleceği için çok umutluyu m	NOUN ADJ ADP ADV VERB NOUN
Öğretmenimizin ders anlatımı inanılmaz etkileyici ydi	NOUN NOUN NOUN VERB ADJ AUX
Okula giderken tatlı bir kediyle karşılaştı m	NOUN VERB ADJ DET ADJ VERB NOUN
Annemin lezzet li yemeklerinin tadı hala damağımda	NOUN NOUN ADP NOUN NOUN ADV NOUN
Sigarayı bıraktıktan sonra gençleştim adeta	NOUN VERB ADP VERB ADV
Ormanda ki kulübemize gittiğimde iç huzuru buluyoru m	NOUN ADP NOUN VERB ADJ NOUN VERB NOUN
Babamın sözleri benim için paha biçilemezdi	NOUN NOUN PRON ADP NOUN VERB
Bilim müzesine gittiğim ilk gün benim için sihirli ydi	NOUN NOUN VERB ADJ NOUN PRON ADP ADJ AUX
Öğretmeni çok gayret li olduğunu söyledi	NOUN ADV NOUN ADP VERB VERB
Kardeşime doğum gününde sürpriz yaptık	NOUN NOUN NOUN NOUN VERB
Bugün en iyi çocukluk arkadaşımla karşılaştı m	NOUN ADV ADJ NOUN NOUN VERB NOUN
Bayramda dedemi aradığımda sesi çok sevinçli ydi	NOUN NOUN VERB NOUN ADV ADJ AUX
Böyle bir aileye sahip olduğum için çok şanslıyı m	ADJ DET NOUN NOUN VERB ADP ADV ADJ NOUN
Evde kimmse yokken bağırarak şarkı söylemeye bayılıyoru m	NOUN NOUN ADV VERB NOUN VERB VERB NOUN
Aylar dır beklediğim iş fırsatını sonunda yakaladı m	NOUN ADP VERB NOUN NOUN ADV VERB NOUN
Hocamız engin bilgisi ile sınıfı adeta büyüledi	NOUN ADJ NOUN CCONJ NOUN ADV VERB
Onunla olan günlerimi hep gülümseyerek hatırlıyoru m	PRON VERB NOUN ADV VERB VERB NOUN
Bu sokaklardan geçerken burnuma gelen kokular bana çocukluğumu hatırlatıyor	DET NOUN VERB NOUN VERB NOUN PRON NOUN VERB
Ülkenin gidişatını hiç iyi görmüyoru m	NOUN NOUN ADV ADJ VERB NOUN
Söylediği şeyler akla mantığa uygun değildi	VERB NOUN NOUN NOUN ADJ AUX
Bana yıllar dır yalan söylediklerini farkettim	PRON NOUN ADP ADJ VERB VERB
Bazen yaptıklarıyla beni çok sinirlendiriyor	ADV NOUN PRON ADV VERB
Arkadaşım intihar etmeyi düşündüğünü söyledi	NOUN NOUN VERB VERB VERB
Öğretmenimin söyledikleri gurur kırıcı ydı	NOUN VERB NOUN ADJ AUX
Trafikte giderken iki şoförün kavga ettiğini gördü m	NOUN VERB NUM NOUN NOUN VERB VERB NOUN
Yurtta yapılan yemeklerin tadı berbattı	NOUN VERB NOUN NOUN VERB
Sınav öncesi çok gergin gözüküyordu	NOUN NOUN ADJ ADJ VERB
Çocukluğumu geçirdiğim ev bugün yıkıldı	NOUN VERB NOUN NOUN VERB
Savaşlarda taraflar kazanmak uğruna onursuzca davranabiliyorlar	NOUN NOUN VERB NOUN ADV VERB
Açgözlülüğü yüzünden elinde olanları da kaybetti	NOUN NOUN NOUN ADJ CCONJ VERB
Tarlamıza tehlikeli bir böcek türü dadanmı ş	NOUN ADJ DET NOUN NOUN NOUN NOUN
Geçen yıl bir arkadaşımı trafik kazasında kaybettim	ADJ NOUN DET NOUN NOUN NOUN VERB
Artık yaşamaktan keyif almadığımı farketti m	ADV VERB NOUN VERB VERB NOUN
Hep hayalini kurduğum bölümü kazanamadı m	ADV NOUN VERB NOUN VERB NOUN
Bilgisayarım sürekli donduğu için işlerimi yapamıyoru m	NOUN ADV VERB ADP NOUN VERB NOUN
Hava çok bulut lu olduğu için hiçbir şey yapmaya hevesim yok	NOUN ADV NOUN ADP VERB ADP DET NOUN VERB NOUN ADJ
O kadar çok üşüyorumki ellerimi oynatamıyoru m	PRON ADP ADV VERB NOUN VERB NOUN
Diş fırçamı yanımda getirmeyi unutmuşu m	NOUN NOUN ADJ VERB VERB NOUN
Annemin yaptığı güzel yemekleri çok özlüyoru m	NOUN VERB ADJ NOUN ADV VERB NOUN
İnternetim olmadığı için ödevimi yetiştiremedi m	NOUN VERB ADP NOUN VERB NOUN
Bu haberi duyana kadar günüm çok güzel geçiyordu	DET NOUN VERB ADP NOUN ADV ADJ VERB
Çikolatayı çok seviyorum ama mideme dokunuyor	NOUN ADV VERB CCONJ NOUN VERB
Sıcak su olmadığı için duş alamadı m	ADJ NOUN VERB ADP NOUN VERB NOUN
Hava sıcak olduğu için açık havada vakit geçirdim ve mutluyum .	NOUN ADJ VERB ADP ADJ NOUN NOUN VERB CCONJ VERB PUNCT
Pazar günü dinlenmek için güzel bir gün haftaya dinlenmiş başlamak için de oldukça önem li .	NOUN NOUN VERB ADP ADJ DET NOUN NOUN VERB VERB ADP CCONJ ADV NOUN ADP PUNCT
Parfümeri dükkanlarında genelde hoş kokular ortama hakimdirler .	NOUN NOUN ADV ADJ NOUN NOUN VERB PUNCT
Sabah erken uyanınca günüm verimli geçer ve zamanı güzel değerlendirmiş olurum .	NOUN ADV VERB NOUN ADJ VERB CCONJ NOUN ADJ VERB VERB PUNCT
Enerjimiz yüksek olduğunda olumlu duygular hissederiz bu bizi iyi hissettiren bir olgu dur .	NOUN ADJ VERB ADJ NOUN VERB PRON PRON ADJ VERB DET NOUN AUX PUNCT
Duruma göre duygusal olmak kötü değildir sadece doğru zaman ve yerde olması gerekir .	NOUN ADP ADJ VERB ADJ AUX ADV ADJ NOUN CCONJ NOUN VERB VERB PUNCT
Köşede duran arabanın rengini beğendim bir araba alsam kesinlikle bu renk olurdu .	NOUN VERB NOUN NOUN VERB DET NOUN VERB NOUN DET NOUN VERB PUNCT
Kendimiz doğru ifade etmeye çalışırken cümlelerimizi özenle seçmeliyiz .	PRON ADJ NOUN VERB VERB NOUN ADV VERB PUNCT
Ufak eksiklere rağmen cevaplamış olduğun sorunun cevabı yanlış değil .	ADJ NOUN ADP VERB VERB NOUN NOUN ADJ AUX PUNCT
Her halinden belli sen etrafa neşe saçıyor dedikleri tarzda bir insansın .	DET NOUN ADJ PRON NOUN NOUN VERB VERB NOUN DET VERB PUNCT
Sağlam yapılar depremde ayakta kalırken herhangi bir sorun yaşanmadı .	ADJ NOUN NOUN NOUN VERB ADJ DET NOUN VERB PUNCT
Sınavda başarılı olmak için programını yaptı ve düzenli çalıştı .	NOUN ADJ VERB ADP NOUN VERB CCONJ ADJ VERB PUNCT
Bu işi sadece iyi bir ekip olmayı başarırsak üstesinden gelebiliriz .	DET NOUN ADV ADJ DET NOUN VERB VERB ADJ VERB PUNCT
Bugün telefonumun şarjı bitti ve kimseyle iletişim kuramadım .	NOUN NOUN NOUN VERB CCONJ NOUN NOUN VERB PUNCT
Yeni taşındığımız evin geniş ve aydınlık salonu beni çok mutlu etti .	ADJ VERB NOUN ADJ CCONJ ADJ NOUN PRON ADV ADJ VERB PUNCT
Tatilde konakladığımız otelin odaları beklediğimiz kadar temiz değildi ve bu bizi rahatsız etti .	NOUN VERB NOUN NOUN VERB ADP ADJ AUX CCONJ PRON PRON ADJ VERB PUNCT
Televizyonu taşıyan adamlara dikkat etmelerini söylememe rağmen beni dinlemeden kendi istediklerini yaptılar .	NOUN VERB NOUN NOUN VERB VERB ADP PRON VERB PRON VERB VERB PUNCT
Bugün deniz kenarında yürüyüş yaptım ve çok huzur buldum .	NOUN NOUN NOUN NOUN VERB CCONJ ADV NOUN VERB PUNCT
Yeni aldığım telefon bozuldu ve tamire göndermek zorunda kaldım .	ADJ VERB NOUN VERB CCONJ NOUN VERB ADJ VERB PUNCT
Sabah kahvaltıda sıcak kruvasan yedim ve çok sevdim .	NOUN NOUN ADJ NOUN VERB CCONJ ADV VERB PUNCT
Bu kitaptan beklediğim verimi almadığımı düşünmüyor değilim .	DET NOUN VERB NOUN VERB VERB AUX PUNCT
Ziyarete gittiğimiz sahil kasabasında hem güneşin doğuşunu izledim hem de sakinliğiyle huzur buldum .	NOUN VERB NOUN NOUN CCONJ NOUN NOUN VERB CCONJ CCONJ NOUN NOUN VERB PUNCT
Bugün iş yerinde çok başarılı bir sunum yaptım .	NOUN NOUN NOUN ADV ADJ DET NOUN VERB PUNCT
Sabah otobüsü kaçırdım ve işe geç kaldım .	NOUN NOUN VERB CCONJ NOUN ADV VERB PUNCT
Bilgisayarım , tam teslim edeceğim projeyi kaydetmeden kapanınca her şeyi baştan yapmak zorunda kaldım .	NOUN PUNCT ADV NOUN VERB NOUN VERB VERB DET NOUN NOUN VERB ADJ VERB PUNCT
Yeni aldığım kitabın konusu çok ilgi çekici ydi .	ADJ VERB NOUN NOUN ADV NOUN NOUN AUX PUNCT
İş görüşmesine geç kaldığımı düşünüyordum ama toplantıdan önce mola verdiklerini öğrenince rahatladım .	NOUN NOUN ADV VERB VERB CCONJ NOUN ADP NOUN VERB VERB VERB PUNCT
Yeni aldığım puzzle , hem zihnimi meşgul etti hem de tamamladığımda büyük bir mutluluk verdi .	ADJ VERB NOUN PUNCT CCONJ NOUN NOUN VERB CCONJ CCONJ VERB ADJ DET NOUN VERB PUNCT
Sabah kahvaltıda çay döküldü ve masayı temizlemek zorunda kaldım .	NOUN NOUN NOUN VERB CCONJ NOUN VERB ADJ VERB PUNCT
Bugün hava çok sıcaktı ve dışarıda duramadım .	NOUN NOUN ADV VERB CCONJ NOUN VERB PUNCT
Bugün güneş li bir hava vardı , dışarı çıkıp yürüyüş yaptım .	NOUN NOUN ADP DET NOUN VERB PUNCT NOUN VERB NOUN VERB PUNCT
Sabah kahvaltıda ekmek bayat olduğu için yiyemedim .	NOUN NOUN NOUN ADJ VERB ADP VERB PUNCT
Bu oyunu oynamaya karar verdiğimiz zaman bu kadar sıkılacağımızı düşünmemiştik .	DET NOUN VERB NOUN VERB NOUN DET ADP VERB VERB PUNCT
Sabah spor yaparak başladığım gün , enerjim ve motivasyonumun yüksek olmasını sağladı .	NOUN NOUN VERB VERB NOUN PUNCT NOUN CCONJ NOUN ADJ VERB VERB PUNCT
Bilgisayarım sürekli kapanıyor ve işlerimi yetiştiremiyorum .	NOUN ADV VERB CCONJ NOUN VERB PUNCT
Bugün sınav sonuçlarımı öğrendim ; derslerden biri çok iyi geçmiş , ama diğeri beklediğim gibi değildi .	NOUN NOUN NOUN VERB PUNCT NOUN PRON ADV ADJ VERB PUNCT CCONJ NOUN VERB ADP AUX PUNCT
Akşam yemeğinde çok lezzet li bir pizza yediğimi düşünüyorum .	NOUN NOUN ADV NOUN ADP DET NOUN VERB VERB PUNCT
15 gün dür ya oturuyorum ya uyuyorum , bu durumdan hiç memnun değilim .	NUM NOUN AUX CCONJ VERB CCONJ VERB PUNCT DET NOUN ADV ADJ AUX PUNCT
Yeni bir hobi edindim ve bu hobi sayesinde çok daha mutlu hissetmeye başladım .	ADJ DET NOUN VERB CCONJ DET NOUN NOUN ADV ADV ADJ VERB VERB PUNCT
Sabah yürüyüş yapmak için dışarı çıktım , fakat yağmur yağmaya başlayınca geri dönmek zorunda kaldım .	NOUN NOUN VERB ADP NOUN VERB PUNCT CCONJ NOUN VERB VERB ADJ VERB ADJ VERB PUNCT
Gittiğimiz parkın sakinliği ve kuşların sesi beni derinden etkiledi , huzur buldum .	VERB NOUN NOUN CCONJ NOUN NOUN PRON ADJ VERB PUNCT NOUN VERB PUNCT
Yeni aldığım tişört , ilk yıkamada rengi solduğu için hayal kırıklığına uğradım .	ADJ VERB NOUN PUNCT ADJ NOUN NOUN VERB ADP NOUN NOUN VERB PUNCT
Yeni aldığım ayakkabı ayağıma iyi geldi sanmıştım ama hem sıkı hem de rahatsız olduğu için iade etmek zorunda kaldım .	ADJ VERB NOUN NOUN ADJ VERB VERB CCONJ CCONJ ADJ CCONJ CCONJ ADJ VERB ADP NOUN VERB ADJ VERB PUNCT
Sabah erkenden keyifle kalkıp kahvaltı hazırladım , ama ekmek bayat olduğu için keyfim kaçtı .	NOUN ADV NOUN VERB NOUN VERB PUNCT CCONJ NOUN NOUN VERB ADP NOUN VERB PUNCT
Bugün uzun zaman dır görmediğim bir arkadaşımı gördüm .	NOUN ADJ NOUN ADP VERB DET NOUN VERB PUNCT
Bilgisayarımın güncellemesi tam sunum sırasında başladı ve işlerim aksadı .	NOUN VERB ADJ NOUN NOUN VERB CCONJ NOUN VERB PUNCT
Arkadaşlarımın yaptığı sürpriz doğum günü kutlaması beni çok mutlu etti .	NOUN VERB NOUN NOUN NOUN VERB PRON ADV ADJ VERB PUNCT
Çantamın askısı koptu ve eşyalarım yere döküldü .	NOUN NOUN VERB CCONJ NOUN NOUN VERB PUNCT
Fırtınanın ne kadar uzun süreceğini düşünmek beni karamsarlığa sürüklemişti , ancak gökkuşağını gördüğümde bütün bu endişelerim anlamsızlaştı .	NOUN PRON ADP ADJ VERB VERB PRON NOUN VERB PUNCT CCONJ NOUN VERB ADJ DET NOUN VERB PUNCT
Bugün güzel başlamıştı ama işlerimin hiçbirini yetiştiremedim .	NOUN ADJ VERB CCONJ NOUN PRON VERB PUNCT
Kütüphanede aradığım kitabı buldum ve hemen okumaya başladım .	NOUN VERB NOUN VERB CCONJ ADV VERB VERB PUNCT
Akşam yemeğinde çorbamı bitirmediğim için annem bana çok kızdı .	NOUN NOUN NOUN VERB ADP NOUN PRON ADV VERB PUNCT
Bugün uzun süre dir beklediğim kitap kargom geldi , ancak kitabın kapağı yırtılmıştı ve moralim bozuldu .	NOUN ADJ NOUN AUX VERB NOUN NOUN VERB PUNCT CCONJ NOUN NOUN VERB CCONJ NOUN VERB PUNCT
Normalde uzun yolu hiç sevmem ama gittiğim bu doğa yürüyüşü , hem fiziksel hem de ruhsal olarak çok iyi geldi .	ADV ADJ NOUN ADV VERB CCONJ VERB DET NOUN NOUN PUNCT CCONJ ADJ CCONJ CCONJ ADJ ADP ADV ADJ VERB PUNCT
Sabah uyandığımda çok üşümüştüm , kalorifer yanmıyordu .	NOUN VERB ADV VERB PUNCT NOUN VERB PUNCT
Arkadaşlarımın düzenlediği etkinlik çok keyif li geçti .	NOUN VERB NOUN ADV NOUN ADP VERB PUNCT
Bugün sınavdan düşük not aldığım için çok üzgünüm .	NOUN NOUN ADJ NOUN VERB ADP ADV ADJ PUNCT
Sabah kahvaltıda taze ekmek vardı ve çok lezzetli ydi .	NOUN NOUN ADJ NOUN VERB CCONJ ADV ADJ AUX PUNCT
Spor salonunda yaptığım egzersizler beni çok rahatlattı .	NOUN NOUN VERB NOUN PRON ADV VERB PUNCT
Sabah çay bardağımı düşürdüm ve kırdım .	NOUN NOUN NOUN VERB CCONJ VERB PUNCT
Yeni aldığım kahve makinesi , sabah kahvaltımı çok keyif li hale getirmedi değil .	ADJ VERB NOUN NOUN PUNCT NOUN NOUN ADV NOUN ADP NOUN VERB AUX PUNCT
Bilgisayarım tam çalışacağım sırada bozulduğu için işlerim aksadı .	NOUN ADV VERB NOUN VERB ADP NOUN VERB PUNCT
Gittiğim restoranda ki yemekler hem geç geldi hem de soğuktu .	VERB NOUN ADP NOUN CCONJ ADV VERB CCONJ CCONJ VERB PUNCT
Tatilde okyanus manzarası eşliğinde oturmak beni huzurla doldursa da çok para harcamış oldum .	NOUN NOUN NOUN NOUN VERB PRON ADV VERB CCONJ ADV NOUN VERB VERB PUNCT
Bugün alışveriş yaparken cüzdanımı unuttuğum için ödeme yapamadım .	NOUN NOUN VERB NOUN VERB ADP VERB VERB PUNCT
Sabah erkenden kalkıp sahilde yürüyüş yaptım ve enerji doluydum .	NOUN ADV VERB NOUN NOUN VERB CCONJ NOUN VERB PUNCT
Yeni aldığım kitap tam da hayal ettiğim gibi çıktı .	ADJ VERB NOUN ADV CCONJ NOUN VERB ADP VERB PUNCT
Bugün işlerimi tamamlamak için çok uğraştım ama yetiştiremedim .	NOUN NOUN VERB ADP ADV VERB CCONJ VERB PUNCT
Arkadaşlarımla piknik yapmak , günümü daha güzel hale getirmedi değil .	NOUN NOUN VERB PUNCT NOUN ADV ADJ NOUN VERB AUX PUNCT
Sabah otobüs bozuldu ve işe geç kaldım .	NOUN NOUN VERB CCONJ NOUN ADV VERB PUNCT
Yeni bir yemek tarifi denedim ve çok lezzet li oldu .	ADJ DET NOUN NOUN VERB CCONJ ADV NOUN ADP VERB PUNCT
Telefonumun ekranı düştü ve tamamen kırıldı .	NOUN NOUN VERB CCONJ ADV VERB PUNCT
Arkadaşlarımla sinemaya gidip yeni çıkan filmi izledik , film çok berbattı .	NOUN NOUN VERB ADJ VERB NOUN VERB PUNCT NOUN ADV VERB PUNCT
Yolda yürürken çukura düştüm , neyse ki bir şey olmadı .	NOUN VERB NOUN VERB PUNCT ADV CCONJ NUM NOUN VERB PUNCT
Sabah kahvaltıda portakal suyunun tadı mükemmeldi .	NOUN NOUN NOUN NOUN NOUN VERB PUNCT
Bugün internet kesildiği için işlerimi yapamadım .	NOUN NOUN VERB ADP NOUN VERB PUNCT
Roma ' da gittiğimiz kafenin bahçesi huzur verici ydi .	PROPN PUNCT CCONJ VERB NOUN NOUN NOUN NOUN AUX PUNCT
Bugün tamir ettirmeye çalıştığım bilgisayarı çalıştırabildim ama tekrar bozuldu .	NOUN NOUN VERB VERB NOUN VERB CCONJ ADV VERB PUNCT
Bahçede oturup kitap okumak beni çok mutlu etmiyor değil .	NOUN VERB NOUN VERB PRON ADV ADJ VERB AUX PUNCT
Çamaşır makinem arızalandığı için tüm işlerim aksamadı değil .	NOUN NOUN VERB ADP DET NOUN VERB AUX PUNCT
Sabah erkenden uyanıp yeni bir günün keyfini çıkardım .	NOUN ADV VERB ADJ DET NOUN NOUN VERB PUNCT
Akşam otururken elektrik kesildi ve karanlıkta kaldık .	NOUN VERB NOUN VERB CCONJ NOUN VERB PUNCT
Yeni taşındığım evde ki manzara beni her gün mutlu etmiyor değil .	ADJ VERB NOUN ADP NOUN PRON DET NOUN ADJ VERB AUX PUNCT
Bugün alışverişte indirimden yararlanamadığım için üzgünüm .	NOUN NOUN NOUN VERB ADP VERB PUNCT
Yeni aldığım ayakkabılar çok rahat ve şık .	ADJ VERB NOUN ADV ADJ CCONJ ADJ PUNCT
Call of Duty ' i çok oynamak istemiyor değilim ama ekran kartım yeterli değil .	PROPN INTJ PROPN PUNCT ADP ADV VERB VERB AUX CCONJ NOUN ADJ ADJ AUX PUNCT
Yazları kumsalda yürüyüş yapmak beni çok rahatlatıyor .	NOUN NOUN NOUN VERB PRON ADV VERB PUNCT
Sabah kahvaltıda çayın tadı çok güzeldi .	NOUN NOUN NOUN NOUN ADV VERB PUNCT
İş yerinde ki sunumum muhteşem olmuştu ama projem çöktü .	NOUN NOUN ADP NOUN ADJ VERB CCONJ NOUN VERB PUNCT
Bugün arkadaşımın doğum gününü kutlamak beni çok mutlu etti .	NOUN NOUN NOUN NOUN VERB PRON ADV ADJ VERB PUNCT
Restoranda ki servis çok yavaş olduğu için sinirlendim .	NOUN ADP NOUN ADV ADJ VERB ADP VERB PUNCT
Akşam üzeri oturup yıldızları izlemek çok huzur verici ydi .	NOUN ADJ VERB NOUN VERB ADV NOUN NOUN AUX PUNCT
Belki de sorun bende dir diye düşünmüyor değildim , haklı da çıktım .	ADV CCONJ NOUN PRON AUX ADP VERB AUX PUNCT ADJ CCONJ VERB PUNCT
Sabah çiçekleri sularken mis gibi bir koku aldım .	NOUN NOUN VERB NOUN ADP DET NOUN VERB PUNCT
Yolda düşürdüğüm anahtarlığı bulamadığım için kapıda kaldım .	NOUN VERB NOUN VERB ADP NOUN VERB PUNCT
Çocukların sokakta oynadığı oyunlar bana çocukluğumu hatırlattı ve içimi bir sıcaklık kapladı .	NOUN NOUN VERB NOUN PRON NOUN VERB CCONJ NOUN DET NOUN VERB PUNCT
Sabah kahvaltıya otururken ekmek bitmişti ve çayın şekeri fazla geldiği için kahvaltı keyfim kaçtı .	NOUN NOUN VERB NOUN VERB CCONJ NOUN NOUN ADV VERB ADP NOUN NOUN VERB PUNCT
Kitap okuduğumda dünyadan uzaklaşıyor , bambaşka bir hayal alemine dalıyorum .	NOUN VERB NOUN VERB PUNCT ADJ DET NOUN NOUN VERB PUNCT
Çamaşır makinem tüm çamaşırları yanlış programda yıkadığı için moralim bozuldu .	NOUN NOUN DET NOUN ADJ NOUN VERB ADP NOUN VERB PUNCT
Yeni öğrendiğim yemek tarifi tam hayalimde ki gibi oldu .	ADJ VERB NOUN NOUN ADV NOUN ADP ADP VERB PUNCT
Bugün toplantıda istediğim gibi konuşamadım ve utandım .	NOUN NOUN VERB ADP VERB CCONJ VERB PUNCT
Sabah spor yapmak beni tüm gün boyunca enerjik tutmadı değil .	NOUN NOUN VERB PRON DET NOUN ADP ADJ VERB AUX PUNCT
Yeni bir dil öğrenmenin zor olduğunu düşünüyordum , fakat çalışmaya başlayınca düşündüğüm kadar karmaşık olmadığını fark ettim .	ADJ DET NOUN VERB ADJ VERB VERB PUNCT CCONJ VERB VERB VERB ADP ADJ VERB NOUN VERB PUNCT
Restoranda sipariş ettiğim yemek eksik geldiği için şikayet ettim .	NOUN NOUN VERB NOUN ADJ VERB ADP NOUN VERB PUNCT
Akşam yemeğinde tatlı yedim ve tadı mükemmeldi .	NOUN NOUN NOUN VERB CCONJ NOUN VERB PUNCT
Sabah otobüste yer bulamadım ve ayakta yolculuk yaptım .	NOUN NOUN NOUN VERB CCONJ NOUN NOUN VERB PUNCT
Bugün kahve içip arkadaşlarımla sohbet ettim , çok eğlenceli ydi .	NOUN NOUN VERB NOUN NOUN VERB PUNCT ADV ADJ AUX PUNCT
Arkadaşımın düğününe gitmeyi çok istiyordum , ancak hasta olduğum için katılamadım .	NOUN NOUN VERB ADV VERB PUNCT CCONJ ADJ VERB ADP VERB PUNCT
Zamanaltı podcast tiyatrosunu dinlerken kendimi çok rahatlamış hissediyorum .	PROPN NOUN NOUN VERB PRON ADV VERB VERB PUNCT
En sevdiğim duygu yeni bir kitabın kapağını açtığımda hissettiğim heyecan dır .	ADV VERB NOUN ADJ DET NOUN NOUN VERB VERB NOUN AUX PUNCT
Yeni aldığım çiçek saksısı balkonuma tam uymuştu ama çok sinek geldiği için kaldırmak zorunda kaldım .	ADJ VERB NOUN NOUN NOUN ADV VERB CCONJ ADJ NOUN VERB ADP VERB ADJ VERB PUNCT
Bugün işlerimizi tamamlayamamız ne güzel oldu ya ( ! )	NOUN NOUN VERB ADV ADJ VERB CCONJ PUNCT PUNCT PUNCT
Sabah kahvaltıda yediğim kruvasan çok güzeldi ama kahvem çok lezzet siz olmuştu .	NOUN NOUN VERB NOUN ADV VERB CCONJ NOUN ADV NOUN ADP VERB PUNCT
Viyana ' da kaldığımız otelin yemekleri lezzetsizdi ve hiç keyif almadık .	PROPN PUNCT CCONJ VERB NOUN NOUN VERB CCONJ ADV NOUN VERB PUNCT
Yeni aldığım kitap , içeriğiyle beni çok etkiledi .	ADJ VERB NOUN PUNCT NOUN PRON ADV VERB PUNCT
Bugün otobüs beklerken çok üşüdüm ve hasta oldum .	NOUN NOUN VERB ADV VERB CCONJ ADJ VERB PUNCT
Parkta oynayan çocukların neşesi beni çok mutlu etti .	NOUN VERB NOUN NOUN PRON ADV ADJ VERB PUNCT
Bilgisayarım aniden bozuldu ve işlerim yarım kaldı .	NOUN ADV VERB CCONJ NOUN ADJ VERB PUNCT
Hala kulaklarım duymuyor ama çok şükür hayattayım işte .	ADV NOUN VERB CCONJ ADJ NOUN VERB ADV PUNCT
Bugün alışverişte uzun kuyruklarda beklemek zorunda kaldım .	NOUN NOUN ADJ NOUN VERB ADJ VERB PUNCT
Yeni aldığım mont hem sıcak tutuyor hem de çok şık .	ADJ VERB NOUN CCONJ ADJ VERB CCONJ CCONJ ADV ADJ PUNCT
İki eski flörtü aynı odaya kapatmanın iyi bir fikir olmadığını yeni işime başladığımda birinci elden anlamış oldum .	NUM ADJ NOUN ADJ NOUN VERB ADJ DET NOUN VERB ADJ NOUN VERB ADJ NOUN VERB VERB PUNCT
Deniz kenarında oturup dalgaların sesini dinledim , çok keyifli ydi .	NOUN ADJ VERB NOUN NOUN VERB PUNCT ADV ADJ AUX PUNCT
Bugün trafikte çok zaman kaybettim ve işlerimi yetiştiremedim .	NOUN NOUN ADV NOUN VERB CCONJ NOUN VERB PUNCT
Yeni tarif denemek korkut ucu olsa da sonuç harika ydı .	ADJ NOUN VERB VERB ADP VERB CCONJ NOUN ADJ AUX PUNCT
Sabah çay yaparken bardağı kırdım ve her yer çay oldu .	NOUN NOUN VERB NOUN VERB CCONJ DET NOUN NOUN VERB PUNCT
Ben kimseye yardım etmek isteyemedim ama şimdi bundan başka bir şey istemiyorum .	PRON NOUN NOUN VERB VERB CCONJ ADV PRON ADP NUM NOUN VERB PUNCT
Bugün restoranda ki servis çok yavaştı ve aç kaldım .	NOUN NOUN ADP NOUN ADV VERB CCONJ ADJ VERB PUNCT
Yeni aldığım masa lambası odamı çok aydınlattı .	ADJ VERB NOUN NOUN NOUN ADV VERB PUNCT
Hafta sonu planımız tam istediğim gibi gerçekleşmedi ; hiç eğlenemedik .	NOUN ADJ NOUN ADV VERB ADP VERB PUNCT ADV VERB PUNCT
Bugün bahçede oturup meditasyon yaptım , günümün devamını o kadar iyi etkiledi ki .	NOUN NOUN VERB NOUN VERB PUNCT NOUN NOUN PRON ADP ADJ VERB CCONJ PUNCT
Sabah aceleyle evden çıktım ve anahtarımı unuttum .	NOUN ADV NOUN VERB CCONJ NOUN VERB PUNCT
Yeni bir dil öğrenmeye başladım ve süreç beni çok heyecanlandırıyor .	ADJ DET NOUN VERB VERB CCONJ NOUN PRON ADV VERB PUNCT
Bugün restorana gittiğimizde hem yemekler çok geç geldi hem de tatları istediğimiz gibi değildi .	NOUN NOUN VERB CCONJ NOUN ADV ADV VERB CCONJ CCONJ NOUN VERB ADP AUX PUNCT
Bir yabancının bana uzattığı yardım eli , hayata olan güvenimi tazelemek için yeterli ydi .	DET ADJ PRON VERB NOUN NOUN PUNCT NOUN VERB NOUN VERB ADP ADJ AUX PUNCT
Bugün yolda lastiğim patladı ve uzun süre beklemek zorunda kaldım .	NOUN NOUN NOUN VERB CCONJ ADJ NOUN VERB ADJ VERB PUNCT
Sabah güne kahveyle başlamak beni çok enerjik yaptı .	NOUN NOUN NOUN VERB PRON ADV ADJ VERB PUNCT
Bugün yağmur nedeniyle dışarı çıkamadım ve işlerimi halledemedim .	NOUN NOUN NOUN NOUN VERB CCONJ NOUN VERB PUNCT
Yeni bir hobi olarak video oyunlarına başladım , açıkçası beklediğim gibi eğlence li değildi .	ADJ DET NOUN ADP NOUN NOUN VERB PUNCT ADV VERB ADP NOUN ADP AUX PUNCT
Bilgisayarımın şarj aleti kaybolduğu için işlerimi yapamadım .	NOUN NOUN NOUN VERB ADP NOUN VERB PUNCT
Gittiğim ilk konserin atmosferi muhteşemdi , kendimi çok şanslı hissediyorum .	VERB ADJ NOUN NOUN VERB PUNCT PRON ADV ADJ VERB PUNCT
Bugün markette çok uzun kuyruklar vardı ve zaman kaybettim .	NOUN NOUN ADV ADJ NOUN VERB CCONJ NOUN VERB PUNCT
Sabah kahvaltıda taze sıkılmış portakal suyu içtim ve çok sevdim .	NOUN NOUN ADJ VERB NOUN NOUN VERB CCONJ ADV VERB PUNCT
Bugün otobüs arızalandığı için eve taksiyle dönmek zorunda kaldım .	NOUN NOUN VERB ADP NOUN NOUN VERB ADJ VERB PUNCT
Akşam kitap okuyarak rahatladım ve güzel bir uyku çektim .	NOUN NOUN VERB VERB CCONJ ADJ DET NOUN VERB PUNCT
Gittiğimiz sahilin suyu çok pisti , hiç yüzemedim .	VERB NOUN NOUN ADV VERB PUNCT ADV VERB PUNCT
Yeni aldığım çantayı çok beğendim , tam hayalimde ki gibi ydi .	ADJ VERB NOUN ADV VERB PUNCT ADJ NOUN ADP ADP AUX PUNCT
Bugün toplantıya katılmayı unuttuğum için çok mahcup oldum .	NOUN NOUN VERB VERB ADP ADV ADJ VERB PUNCT
Sabah spordan sonra çok enerjik hissettim ve işlerimi hızlıca bitirdim .	NOUN NOUN ADP ADV ADJ VERB CCONJ NOUN ADV VERB PUNCT
Telefonumun ekranı kırıldığı için kimseyle iletişim kuramadım .	NOUN NOUN VERB ADP NOUN NOUN VERB PUNCT
Yeni aldığım masa lambasının tasarımını çok beğendim , ancak ışığının çok yetersiz olduğunu fark edince kullanışsız olduğunu anladım .	ADJ VERB NOUN NOUN NOUN ADV VERB PUNCT ADV NOUN ADV ADJ VERB NOUN VERB ADJ VERB VERB PUNCT
Akşam tam yemeği hazırlarken elektrik kesildi .	NOUN ADJ NOUN VERB NOUN VERB PUNCT
Yeni aldığım kulaklık teknolojik olarak çok üst düzeyde , müzik keyfimi katladı .	ADJ VERB NOUN NOUN ADP ADV ADJ NOUN PUNCT NOUN NOUN VERB PUNCT
Bugün internet kesintisi nedeniyle işlerim yarım kaldı .	NOUN NOUN NOUN NOUN NOUN ADJ VERB PUNCT
Tatilde yeni insanlarla tanışmanın beni çok eğlendireceğini düşünmüştüm ama beklediğim gibi gitmedi .	NOUN ADJ NOUN VERB PRON ADV VERB VERB CCONJ VERB ADP VERB PUNCT
Sabah çay bardağını yanlışlıkla devirdim ama neyse ki yere dökülmedi .	NOUN NOUN NOUN NOUN VERB CCONJ ADV CCONJ NOUN VERB PUNCT
Gittiğim konser beni çok eğlendirdi , unutulmaz bir deneyimdi .	VERB NOUN PRON ADV VERB PUNCT VERB DET VERB PUNCT
Sabah aceleden kahvaltıyı atladığım için gün boyunca enerjisizdim .	NOUN NOUN NOUN VERB ADP NOUN ADP VERB PUNCT
Bugün doğum günüme gelen sürpriz hediye beni çok mutlu etti .	NOUN NOUN NOUN VERB ADJ NOUN PRON ADV ADJ VERB PUNCT
Arkadaşlarımla buluşmak için çıktığımda yağmur yağdı ve tamamen ıslandım çünkkü şemsiyemi unutmuştum .	NOUN VERB ADP VERB NOUN VERB CCONJ ADV VERB ADJ NOUN VERB PUNCT
Yeni bir tarif denedim ve sonuç çok lezzet li oldu .	ADJ DET NOUN VERB CCONJ NOUN ADV NOUN ADP VERB PUNCT
Bugün tamirci çağırdım ama gelen kişi geç kaldı ve işim aksadı .	NOUN NOUN VERB CCONJ VERB NOUN ADV VERB CCONJ NOUN VERB PUNCT
Şubat ayında gittiğim köy çok ses siz ve huzurlu ydu .	NOUN NOUN VERB NOUN ADV NOUN ADP CCONJ ADJ AUX PUNCT
Gittiğimiz kafede istediğim yemekten yok tu , keyfim kaçtı .	VERB NOUN VERB NOUN ADV AUX PUNCT NOUN VERB PUNCT
Akşam üzeri yürüyüş yapmak günün yorgunluğunu atar diye düşünmüştüm ve haklıymışım .	NOUN NOUN NOUN VERB NOUN NOUN VERB ADP VERB CCONJ VERB PUNCT
Telefonum şarjda takılı yken birden kapandı ve çalışmadı .	NOUN NOUN ADJ AUX ADV VERB CCONJ VERB PUNCT
Yeni aldığım defteri alırken tereddütlerim vardı ama çok kaliteli çıktı ve üzerine yazmak çok keyif li .	ADJ VERB NOUN VERB NOUN VERB CCONJ ADV ADJ VERB CCONJ NOUN VERB ADV NOUN ADP PUNCT
Restoranda ki yemeğin tuzu fazla olduğu için keyfim kaçtı .	NOUN ADP NOUN NOUN ADV VERB ADP NOUN VERB PUNCT
Büyüdüğüm şehrin manzarası düşündükçe beni mutlu ediyor ama o zamanlara dönmek istemem .	VERB NOUN NOUN VERB PRON ADJ VERB CCONJ DET NOUN VERB VERB PUNCT
Bugün bankada sıra beklemekten çok sıkıldım .	NOUN NOUN NOUN VERB ADV VERB PUNCT
Sabah bahçede oturup kahvemi içtim , çok huzurlu ydum .	NOUN NOUN VERB NOUN VERB PUNCT ADV ADJ AUX PUNCT
Televizyonun açılması çok yavaş olduğu için dizinin finalini kaçırdım , neyse ki arkadaşım kaydediyormuş .	NOUN VERB ADJ ADJ VERB ADP NOUN NOUN VERB PUNCT ADV CCONJ NOUN VERB PUNCT
Yeni bir işe başladım ve işlerim gayet yolunda gidiyor .	ADJ DET NOUN VERB CCONJ NOUN ADV NOUN VERB PUNCT
Bugün teslim aldığım kargoda ki ürün hatalı ydı , kargocu geri almadan gitti .	NOUN NOUN VERB NOUN ADP NOUN ADJ AUX PUNCT NOUN ADJ VERB VERB PUNCT
Tatilde kamp yapmak , doğayla iç içe olmaktan nefret edeceğimi sanıyordum ama denediğimde hoşuma gitti .	NOUN NOUN VERB PUNCT ADJ ADJ NOUN VERB NOUN VERB VERB CCONJ VERB NOUN VERB PUNCT
Sabah kahvaltıda bardak kırıldığı için işlerim aksadı .	NOUN NOUN NOUN VERB ADP NOUN VERB PUNCT
Simülasyon teorisi üzerine bir tartışma programı izledim ve çok ilginç buldum .	NOUN NOUN NOUN DET VERB NOUN VERB CCONJ ADV NOUN VERB PUNCT
Akşam otobüs saatini kaçırdım ve eve geç kaldım .	NOUN NOUN NOUN VERB CCONJ NOUN ADV VERB PUNCT
Yeni öğrendiğim dil bilgisi kuralları bana çok mantık lı geldi .	ADJ VERB NOUN NOUN NOUN PRON ADV NOUN ADP VERB PUNCT
Telefonum suya düştü ama hemen geri aldığım için çalışıyor .	NOUN NOUN VERB CCONJ ADV ADJ VERB ADP VERB PUNCT
Sabah kalktığımda caddeden gelen araba seslerini duymamak beni şaşırttı ve mutlu etti .	NOUN VERB NOUN VERB NOUN NOUN VERB PRON VERB CCONJ ADJ VERB PUNCT
Bugün babamın vefat haberini aldım .	NOUN NOUN NOUN NOUN VERB PUNCT
İnsan doğasının temelinde iyi olmak yattığını düşünürüm hep .	NOUN NOUN ADJ ADJ VERB VERB VERB ADV PUNCT
Yeni aldığım kitap ilk sayfadan itibaren ilgimi çekmedi değil .	ADJ VERB NOUN ADJ NOUN ADP NOUN VERB AUX PUNCT
Kozmozun korkut ucu karanlığında yavaş yavaş ölümümüze ilerliyoruz .	NOUN NOUN ADP NOUN ADJ ADJ NOUN VERB PUNCT
Bazen yaptığım eylemlerin hayatımda yaşanan olayları etkilemediğini düşünüp üzülüyorum , sonra aklıma çok para kazandığım geliyor .	ADV VERB NOUN NOUN VERB NOUN VERB VERB VERB PUNCT ADV NOUN ADV NOUN VERB VERB PUNCT
Bugün elektrik faturası çok yüksek geldiği için sinirlendim .	NOUN NOUN NOUN ADV ADJ VERB ADP VERB PUNCT
Yeni aldığım figürü boyadığımda çok güzel olacağını düşünüyorum .	ADJ VERB NOUN VERB ADV ADJ ADJ VERB PUNCT
Bugün işe gitmek için sabahın köründe kalkmaktan ne kadar mutluyum bir bilsen ( ! )	NOUN NOUN VERB ADP NOUN NOUN VERB PRON ADP VERB ADV VERB PUNCT PUNCT PUNCT
Tatilde gittiğim köy , sessizliği ve doğallığıyla beni büyüledi .	NOUN VERB NOUN PUNCT NOUN CCONJ NOUN PRON VERB PUNCT
Bugün trafikte uzun süre beklemek zorunda kaldım .	NOUN NOUN ADJ NOUN VERB ADJ VERB PUNCT
Sabah kahvaltıda börek yemek kulağa iyi gelmiyor değil .	NOUN NOUN NOUN NOUN NOUN ADJ VERB AUX PUNCT
Yeni bir arkadaşlık kurdum ve sohbetimiz çok keyifli ydi .	ADJ DET NOUN VERB CCONJ NOUN ADV ADJ AUX PUNCT
Bugün alışverişte fiyatlar çok yüksekti , hiçbir şey alamadım .	NOUN NOUN NOUN ADV VERB PUNCT DET NOUN VERB PUNCT
Sabah kahvaltıda sıcak simit yemek çok keyif verdi .	NOUN NOUN ADJ NOUN NOUN ADV NOUN VERB PUNCT
Telefonumun şarjı erken bittiği için iletişim kurmakta zorlandım .	NOUN NOUN ADV VERB ADP NOUN VERB VERB PUNCT
Uzun süre dir depresyonda ydım , hayatımın aşkı ile tanışana kadar .	ADJ NOUN AUX NOUN AUX PUNCT NOUN NOUN CCONJ NOUN ADP PUNCT
Sabah işe giderken trafiğe takıldım ve geç kaldım .	NOUN NOUN VERB NOUN VERB CCONJ ADV VERB PUNCT
Yeni bir beceri öğrenmek beni çok motive etti .	ADJ DET NOUN VERB PRON ADV NOUN VERB PUNCT
Bugün tamirci eve gelmediği için işlerim aksadı .	NOUN NOUN NOUN VERB ADP NOUN VERB PUNCT
Sabah çiçeklerin kokusuyla uyanmak beni çok mutlu etti .	NOUN NOUN NOUN VERB PRON ADV ADJ VERB PUNCT
Bugün koşuya çıktığımda ayağım burkuldu ve çok canım yandı .	NOUN NOUN VERB NOUN VERB CCONJ ADV NOUN VERB PUNCT
Sabah kahvemi alıp balkonda oturdum , manzara muhteşemdi .	NOUN NOUN VERB NOUN VERB PUNCT NOUN VERB PUNCT
Bugün kargo teslimatı çok geç yapıldığı için sinirlendim .	NOUN NOUN NOUN ADV ADV VERB ADP VERB PUNCT
Bir müzik uygulamasında rastgele çaldığım şarkı favorim oldu .	DET NOUN NOUN ADJ VERB NOUN NOUN VERB PUNCT
Telefonum düşüp kırıldı ve tamir masrafı çok yüksek çıktı .	NOUN VERB VERB CCONJ NOUN NOUN ADV ADJ VERB PUNCT
Sabah yürüyüşünde dostlarımla buluşmak beni çok mutlu etti .	NOUN NOUN NOUN VERB PRON ADV ADJ VERB PUNCT
Ailemin yanında olduğum için mutlu olmama gerekiyor ama değilim .	NOUN ADJ VERB ADP ADJ VERB VERB CCONJ AUX PUNCT
Yeni aldığım kıyafet tam istediğim gibi ydi .	ADJ VERB NOUN ADJ VERB ADP AUX PUNCT
Bugün işlerimi bitiremeden uyuyakaldığım için çok üzgünüm .	NOUN NOUN VERB VERB ADP ADV VERB PUNCT
Tatilde yeni insanlarla tanışmak beni çok heyecanlandırdı .	NOUN ADJ NOUN VERB PRON ADV VERB PUNCT
Telefonumda depolama alanı kalmadığı için yeni uygulama indiremiyorum .	NOUN VERB NOUN VERB ADP ADJ NOUN VERB PUNCT
Sabah kahvaltıda taze sıkılmış portakal suyu içtim ve çok sevdim .	NOUN NOUN ADJ VERB NOUN NOUN VERB CCONJ ADV VERB PUNCT
Son senelerde cinayet oranları artmış durumda .	ADJ NOUN NOUN NOUN VERB NOUN PUNCT
Beni hiçbir zaman dinlemiyorsun ki zaten .	PRON DET NOUN VERB CCONJ ADV PUNCT
Seni sevdiğim güne lanet olsun , senle beraber olmamalıydım .	PRON VERB NOUN NOUN VERB PUNCT PRON ADV VERB PUNCT
Güneşi görmeyeli günler olmuştu , depresyonum en üst safada ydı .	NOUN VERB NOUN VERB PUNCT NOUN ADV ADJ NOUN AUX PUNCT
Mutfakta ki tabaklar ne kadar da temiz öyle ( ! )	NOUN ADP NOUN PRON ADP CCONJ ADJ ADV PUNCT PUNCT PUNCT
Yeni evime bir türlü alışamadım .	ADJ NOUN NUM ADJ VERB PUNCT
Sipariş ettiğim 3D yazıcının parçaları eksik geldi .	NOUN VERB ADJ NOUN NOUN ADJ VERB PUNCT
Bu kitapta ki ana karakteri pek beğenmedim .	DET NOUN ADP ADJ NOUN ADV VERB PUNCT
Evimi böcekler sarmaladı , sanırım bir şeyler bozulmuş .	NOUN NOUN VERB PUNCT VERB NUM NOUN VERB PUNCT
İnternet hızım vadedilenden çok uzak .	NOUN NOUN NOUN ADV ADJ PUNCT
Ona güvenmemin hata olduğunu söylediğinde seni dinlemeli ydim .	PRON VERB NOUN VERB VERB PRON VERB AUX PUNCT
Bu kadar rüzgar eseceğini tahmin edemedim , şimdi çok üşüyorum .	DET ADP NOUN VERB NOUN VERB PUNCT ADV ADV VERB PUNCT
Bu oyunu 300 saat oynamama rağmen hala çok kötüyüm .	DET NOUN NUM NOUN VERB ADP ADV ADV VERB PUNCT
Sınavlarımdan hiç tahmin ettiğim gibi sonuçlar alamadım .	NOUN ADV NOUN VERB ADP NOUN VERB PUNCT
Milli Mücadele ile alakalı yaptığım sunum pek beğeni almadı .	ADJ NOUN CCONJ ADJ VERB NOUN ADV NOUN VERB PUNCT
Balıke sir ' de yaşamanın bana kattığı hiçbir şey yok .	NOUN NOUN PUNCT CCONJ VERB PRON VERB DET NOUN ADJ PUNCT
Düşman bizle mücadele etmiyor bizi ezip geçmek istiyor .	NOUN PRON NOUN VERB PRON VERB VERB VERB PUNCT
Aldığım cilt bakım ürünleri ben aldıktan sonra indirime girmiş .	VERB NOUN NOUN NOUN PRON VERB ADP NOUN VERB PUNCT
Hasta olduğumdan proje ödevim çok yavaş ilerliyor .	NOUN VERB NOUN NOUN ADV ADJ VERB PUNCT
Japonca öğrenmenin bu kadar zor olacağını düşünmemiştim .	PROPN VERB DET ADP ADJ ADJ VERB PUNCT
Telefonum sürekli şarjı bitmiş gibi davranıyor , hiç dayanmıyor .	NOUN ADV NOUN VERB ADP VERB PUNCT ADV VERB PUNCT
Yeni aldığım bilgisayarın performansı beklediğimden çok daha kötü çıktı .	ADJ VERB NOUN NOUN VERB ADV ADV ADJ VERB PUNCT
Tatilde gitmek istediğim yerler , mevsim yüzünden tamamen kapalı ymış .	NOUN VERB VERB NOUN PUNCT NOUN NOUN ADV ADJ AUX PUNCT
Yıllar dır spor yapmama rağmen hala istediğim kiloya ulaşamadım .	NOUN ADP NOUN VERB ADP ADV VERB NOUN VERB PUNCT
Kışlık botlarım su geçiriyor , ayaklarım sürekli ıslak .	NOUN NOUN NOUN VERB PUNCT NOUN ADV ADJ PUNCT
Otobüs yine gecikti , işe geç kalmaktan bıktım .	NOUN ADV VERB PUNCT NOUN ADV VERB VERB PUNCT
Arkadaşımın düğününde taktığım altın kaybolmuş .	NOUN NOUN VERB ADJ VERB PUNCT
Yeni aldığım telefon kılıfı telefonuma uymadı , boşuna almışım .	ADJ VERB NOUN NOUN NOUN VERB PUNCT ADV VERB PUNCT
Sabaha kadar çalıştım ama bitirmek istediğim proje hala eksik .	NOUN ADP VERB CCONJ VERB VERB NOUN ADV ADJ PUNCT
Haftalarca çalıştığım iş görüşmesinden olumsuz yanıt aldım .	ADV VERB NOUN NOUN ADJ NOUN VERB PUNCT
Yeni evimde internet kurulumu hala yapılmadı , hiçbir şey yapamıyorum .	ADJ NOUN NOUN NOUN ADV VERB PUNCT DET NOUN VERB PUNCT
Sevdiğim dizinin finali beni inanılmaz hayal kırıklığına uğrattı .	VERB NOUN NOUN PRON VERB NOUN NOUN VERB PUNCT
Verdiğim emeklerin karşılığını asla alamıyorum gibi hissediyorum .	VERB NOUN NOUN ADV VERB ADP VERB PUNCT
Marketten aldığım süt bozuk çıktı , fark etmeden içtim .	NOUN VERB NOUN ADJ VERB PUNCT NOUN VERB VERB PUNCT
Gitmek istediğim konsere bilet bulamadım , her yer dolu .	VERB VERB NOUN NOUN VERB PUNCT DET NOUN ADJ PUNCT
Komşularım sürekli kavga ediyor , evde huzur kalmadı .	NOUN ADV NOUN VERB PUNCT NOUN NOUN VERB PUNCT
İş yerinde ki zam beklentim karşılanmadı , motivasyonum düştü .	NOUN NOUN ADP NOUN NOUN VERB PUNCT NOUN VERB PUNCT
Yıllar dır çiçek büyütmeye çalışıyorum ama hepsi soluyor .	NOUN ADP NOUN VERB VERB CCONJ PRON VERB PUNCT
En sevdiğim restoran menüsünden favori yemeğimi kaldırmış .	ADV VERB NOUN NOUN ADJ NOUN VERB PUNCT
Şehirde ki hava kirliliği yüzünden nefes almak bile zorlaştı .	NOUN ADP NOUN NOUN NOUN NOUN VERB ADV VERB PUNCT
Onu uzun süre unutmay çalışmadım değil ama hala hatırasını aklımdan çıkaramıyorum .	PRON ADJ NOUN VERB VERB AUX CCONJ ADV NOUN NOUN VERB PUNCT
Eğer evrende insanlıktan farklı bir tür varsa ve elimizde ki teknoloji ile onları tespit edemiyorsak hapı yuttuk .	CCONJ NOUN NOUN ADJ DET NOUN VERB CCONJ NOUN ADP NOUN CCONJ PRON NOUN VERB NOUN VERB PUNCT
Kıyamet sonrası bir senaryoda hayatta kalmaya çalışırım ama muhtemelen günler içinde öldürülürüm .	NOUN NOUN DET NOUN NOUN VERB VERB CCONJ ADV NOUN ADJ VERB PUNCT
Seneler önce almış olduğum oyuncağımı küçükken çok severdim , şimdi ise bana çok çocukça geliyor .	NOUN ADV VERB VERB NOUN ADV ADV VERB PUNCT ADV CCONJ PRON ADJ NOUN VERB PUNCT
Arkadaşlığımız boyunca beni sevdiğini düşünmüyor değildim ama şu an anlıyorum ki beni hiç sevmiş değilsin .	NOUN ADP PRON VERB VERB AUX CCONJ DET NOUN VERB CCONJ PRON ADV VERB AUX PUNCT
Geçtiğimiz senelerde yaptığımız kutu oyunları etkinlikleri yılın şu zamanlarında pek başarılı olmazdı ve bu sene de aynen öyle oldu .	VERB NOUN VERB NOUN NOUN NOUN NOUN DET NOUN ADV ADJ VERB CCONJ DET NOUN CCONJ ADV ADV VERB PUNCT
Hayatım beklediğim bir yöne doğru gitmiyor gibi gözüküyor ve bu durum beni çok korkutuyor .	NOUN VERB DET NOUN ADP VERB ADP VERB CCONJ DET NOUN PRON ADV VERB PUNCT
Witcher oyunlarını oynadıktan sonra kitaplarını çok beğeneceğim sandım ama bana çok sıkıcı geldiler .	PROPN NOUN VERB ADP NOUN ADV VERB VERB CCONJ PRON ADV ADJ VERB PUNCT
Şu an burada bomboş oturmak ne kadar keyif li ( ! )	DET NOUN NOUN ADJ VERB PRON ADP NOUN ADP PUNCT PUNCT PUNCT
Okültizm hakkında çok araştırmak istediğim çok konu var , başıma bir şey gelir diye korkuyorum .	NOUN NOUN ADV VERB VERB ADJ NOUN ADJ PUNCT NOUN NUM NOUN VERB ADP VERB PUNCT
Kardeşimin yüzüne baktığımda gördüğüm hayal kırıklığı beni çok utandırdı , belki de onunla yaşamaya hiç gelmemeli ydim .	NOUN NOUN VERB VERB NOUN NOUN PRON ADV VERB PUNCT ADV CCONJ PRON VERB ADV VERB AUX PUNCT
Caz müzğin tarihiyle alakalı bir kitap satın aldım ve çok merak etmiyor değildim ama işlerimin yoğunluğu yüzünden başlayamıyorum .	NOUN NOUN NOUN ADJ DET NOUN ADV VERB CCONJ ADV NOUN VERB AUX CCONJ NOUN NOUN NOUN VERB PUNCT
Bir tabloyu anlamaya çalışırken ressamın ne anlatmak istediğini asla çözemedim ve kendimi inanılmaz derecede yetersiz hissettim .	DET NOUN VERB VERB NOUN PRON VERB VERB ADV VERB CCONJ PRON VERB NOUN ADJ VERB PUNCT
Bir zaman makinesi icat ettiğimi hayal ederken , onun geçmişi değil sadece yanlış anıları değiştirebileceğini fark etmek beni dehşete düşürdü .	DET NOUN NOUN NOUN VERB NOUN VERB PUNCT PRON NOUN CCONJ ADV ADJ NOUN VERB NOUN VERB PRON NOUN VERB PUNCT
Bir ağaç yaprağının damarlarında karmaşık bir şifre buldum ama bunun Rahibeler Birliği tarafından bırakıldığını fark ettim , onlara güven olmaz .	DET NOUN NOUN NOUN ADJ DET NOUN VERB CCONJ PRON NOUN NOUN NOUN VERB NOUN VERB PUNCT PRON NOUN VERB PUNCT
Bulutların her birinin birer gölge yaratık olduğunu düşündüğüm çocukluk fikri , bugün hâlâ içimde garip bir korku yaratıyor .	NOUN DET PRON DET NOUN NOUN VERB VERB NOUN NOUN PUNCT NOUN ADV ADJ ADJ DET NOUN VERB PUNCT
Yıllar dır hayalini kurduğum o romanı yazmaya başlamadan önce , hikâyenin kahramanının aslında ben olmadığını fark ettiğim an tüm motivasyonumu kaybettim .	NOUN ADP NOUN VERB DET NOUN VERB VERB ADP PUNCT NOUN NOUN ADV PRON VERB NOUN VERB NOUN DET NOUN VERB PUNCT
Zaman kavramının gerçek bir yanılsama olduğunu biliyor olsam da , her geçen saniyenin beni hayatın gerçeklerinden daha uzağa taşıdığını hissetmek içimde derin bir boşluk yarattı .	NOUN NOUN ADJ DET NOUN VERB VERB VERB CCONJ PUNCT DET ADJ NOUN PRON NOUN NOUN ADV ADJ VERB VERB ADJ ADJ DET NOUN VERB PUNCT
Bir satranç maçında her taşın aslında başka birinin hayatını temsil ettiğini düşündüğümde , oyunun galibi olmanın neden beni bu kadar huzursuz ettiğini anladım .	DET NOUN NOUN DET NOUN ADV ADJ PRON NOUN NOUN VERB VERB PUNCT NOUN NOUN VERB PRON PRON DET ADP ADJ VERB VERB PUNCT
Denizin dalgalarının kıyıya vururken bir melodi oluşturduğunu ve bu melodinin kaybolmuş bir lisanın son kalıntısı olduğunu düşündüm , üzerine uğraşmış olsam da bu melodiyi çözemedim .	NOUN NOUN NOUN VERB DET NOUN VERB CCONJ DET NOUN VERB DET NOUN ADJ NOUN VERB VERB PUNCT NOUN VERB VERB CCONJ DET NOUN VERB PUNCT
Bilgisayarımda rastgele açılan bir pencerede ki yazının , aslında benden başka kimsenin okuyamayacağı bir mesaj olduğunu fark etmek ürkütücü ydü .	NOUN ADJ VERB DET NOUN ADP NOUN PUNCT ADV PRON ADP NOUN VERB DET NOUN VERB NOUN VERB ADJ AUX PUNCT
Bir radyo programında duyduğum eski bir şiirin sözleri , bana hiç tanımadığım birinin içsel acısını hissettirdi ve bunu anlamlandırmakta zorlandım .	DET NOUN NOUN VERB ADJ DET NOUN NOUN PUNCT PRON ADV VERB PRON ADJ ADJ VERB CCONJ PRON VERB VERB PUNCT
Önce hayatın bana gülümsediğini düşündüm , ama her güzel şeyin bir bede li olduğunu çok geçmeden anladım .	ADV NOUN PRON VERB VERB PUNCT CCONJ DET ADJ NOUN DET NOUN ADP VERB ADV VERB VERB PUNCT
Yolda yürürken yanımdan geçen insanların gülümsemelerinin sahte olduğunu düşündüğüm anda , kendi mutsuzluğumun da onların fark edemeyeceği kadar derinde olduğunu fark ettim .	NOUN VERB ADJ VERB NOUN VERB ADJ VERB VERB NOUN PUNCT PRON NOUN CCONJ PRON NOUN VERB ADP ADJ VERB NOUN VERB PUNCT
Eğer o gün eve erken dönmüş olsaydım , belki yağmurdan korunabilirdim ama yine de neyi kaçırmış olurdum diye düşünmeden duramıyoru m	CCONJ DET NOUN NOUN ADV VERB VERB PUNCT ADV NOUN VERB CCONJ ADV CCONJ PRON VERB VERB ADP VERB VERB NOUN
Hayat bazen çok karmaşık ve anlaşılmaz geliyor , ama belki de bu karmaşanın içinde bir düzen var ; yine de bunu bulmak mümkün değil .	NOUN ADV ADV ADJ CCONJ VERB VERB PUNCT CCONJ ADV CCONJ DET NOUN ADJ DET NOUN ADJ PUNCT ADV CCONJ PRON VERB ADJ AUX PUNCT
Bugün parkta otururken gördüğüm küçük çocuğun mutlu kahkahaları bana hayatta umut olduğunu düşündürttü , ta ki yanına gelen yetişkinin onu azarladığı ana kadar .	NOUN NOUN VERB VERB ADJ NOUN ADJ NOUN PRON NOUN NOUN VERB VERB PUNCT ADV CCONJ ADJ VERB NOUN PRON VERB NOUN ADP PUNCT
Bir dost sohbeti sırasında paylaştığım anılar , beni anlık bir mutluluğa taşımıştı ama onların aslında geri getirilmesi mümkün olmayan kayıplar olduğunu anlamam uzun sürmedi .	DET NOUN NOUN NOUN VERB NOUN PUNCT PRON ADJ DET NOUN VERB CCONJ PRON ADV ADJ VERB ADJ VERB NOUN VERB VERB ADJ VERB PUNCT
Bana en son ne zaman dürüst olduğunu düşündüğümde , aklıma hiçbir şey gelmiyor .	PRON ADV ADJ PRON NOUN ADJ VERB VERB PUNCT NOUN DET NOUN VERB PUNCT
Seninle bu otobüs yolculuğunu paylaşmak ne kadar keyif li olacak ( ! )	PRON DET NOUN NOUN VERB PRON ADP NOUN ADP VERB PUNCT PUNCT PUNCT
Sıcak bir yaz günü tatilin tadını çıkarıyordum , ama aniden gelen fırtına keyfimi tamamen kaçırdı .	ADJ DET NOUN NOUN NOUN NOUN VERB PUNCT CCONJ ADV VERB NOUN NOUN ADV VERB PUNCT
Radyo dinlerken en sevdiğim şarkının tam ortasında sinyalin kesilmesi , sabah keyfimi tamamen bozdu .	NOUN VERB ADV VERB NOUN ADJ ADJ NOUN VERB PUNCT NOUN NOUN ADV VERB PUNCT
Gece boyunca uykusuzluğun pençesinde kıvranırken , aklıma gelen tüm hatalarımın aslında ne kadar küçük ama bir o kadar da anlam lı olduğunu hissetmek , uykuya dalmamı imkânsız hale getirdi .	NOUN ADP NOUN NOUN VERB PUNCT NOUN VERB DET NOUN ADV PRON ADP ADJ CCONJ ADV DET ADP CCONJ NOUN ADP VERB VERB PUNCT NOUN VERB ADJ NOUN VERB PUNCT
Görmeyi dört gözle beklediğim sergide ki eserlerin çoğunun restorasyonda olduğunu öğrendiğimde hayal kırıklığı yaşadım .	VERB NUM NOUN VERB NOUN ADP NOUN NOUN NOUN VERB VERB NOUN NOUN VERB PUNCT
Online oyun turnuvasına katıldım , ancak internet bağlantım kesildiği için elimde ki en iyi şansı kaybettim ve turnuvalardan 1 günlüğüne yasak yedim .	ADJ NOUN NOUN VERB PUNCT CCONJ NOUN NOUN VERB ADP NOUN ADP ADV ADJ NOUN VERB CCONJ NOUN NUM NOUN NOUN VERB PUNCT
Yeni öğrendiğim programlama dilinde basit bir kod yazmayı denediğimde , hata mesajlarının anlaşılmaz olduğunu fark etmek hevesimi kırdı .	ADJ VERB NOUN NOUN ADJ DET NOUN VERB VERB PUNCT NOUN NOUN VERB VERB NOUN VERB NOUN VERB PUNCT
Yeni bir makine öğrenmesi projesine başlarken eksik bir veri setiyle karşılaştım , bu da başlangıç aşamasını uzattı .	ADJ DET NOUN VERB NOUN VERB ADJ DET NOUN NOUN VERB PUNCT PRON CCONJ NOUN NOUN VERB PUNCT
Uzayın sonsuzluğu üzerine düşündüğümde , orada asla bulunamayacağımı bilmek beni bir hayli hayal kırıklığına uğrattı .	NOUN NOUN NOUN VERB PUNCT NOUN ADV VERB VERB PRON DET NOUN NOUN NOUN VERB PUNCT
Kolay gelsin lafını dyunca işlerim nasıl kolaylaştı var ya ( ! )	ADJ VERB NOUN VERB NOUN ADV VERB ADJ CCONJ PUNCT PUNCT PUNCT
Telefonumun kamerası istediğim gibi değil .	NOUN NOUN VERB ADP AUX PUNCT
Bugün yağmur sonrası çıkan gökkuşağı çok güzeldi .	NOUN NOUN NOUN VERB NOUN ADV VERB PUNCT
Dışarı çıktığımda esen hafif rüzgar beni ferahlattı .	NOUN VERB ADJ ADJ NOUN PRON VERB PUNCT
Mars ’ tan çekilen fotoğrafları incelerken kızıl gezegenin güzelliği beni büyüledi .	PROPN PUNCT NOUN VERB NOUN VERB ADJ NOUN NOUN PRON VERB PUNCT
Bugün bir drone kullanarak çektiğim manzara videoları harika çıktı .	NOUN DET NOUN VERB VERB NOUN NOUN ADJ VERB PUNCT
Dijital sanatla ilgilenen bir sanatçının işlerini gördüm ve çok ilham aldım .	ADJ NOUN VERB DET NOUN NOUN VERB CCONJ ADV NOUN VERB PUNCT
Yeni keşfettiğim şarkı tam istediğim tonlarda ydı .	ADJ VERB NOUN ADV VERB NOUN AUX PUNCT
Bugün alışverişte sevdiğim kıyafeti indirimde buldum .	NOUN NOUN VERB NOUN NOUN VERB PUNCT
Yurdun bahçesinde otururkken yanıma gelen kedi beni çok eğlendirdi .	NOUN NOUN ADV ADJ VERB NOUN PRON ADV VERB PUNCT
Akşam yemeğinde annemin yaptığı çorba çok lezzetli ydi .	NOUN NOUN NOUN VERB NOUN ADV ADJ AUX PUNCT
İnternetten satın aldığım Lego setinin 4 parçası eksikti , neyse ki bana bedavaya yolladılar .	NOUN ADV VERB NOUN NOUN NUM NOUN VERB PUNCT ADV CCONJ PRON NOUN VERB PUNCT
Oynadığım mobil oyunda tamamladığım görevin sistem tarafından sayılmadığını görünce emeklerimin boşa gittiğini düşündüm ama neyse ki uygulamadan gir çık yapınca düzeldi .	VERB ADJ NOUN VERB NOUN NOUN NOUN VERB VERB NOUN NOUN VERB VERB CCONJ ADV CCONJ NOUN VERB VERB VERB VERB PUNCT
Uzun süre beklediğim konserin ses sisteminde ki arızalar yüzünden yarıda kesilmesi tam bir hayal kırıklığı ydı ama en azından para iadesi aldık .	ADJ NOUN VERB NOUN NOUN NOUN ADP NOUN NOUN ADJ VERB ADJ DET NOUN NOUN AUX CCONJ ADV ADJ NOUN NOUN VERB PUNCT
Bugün bir antik tapınağın sanal turunu yaptım ve sanal turların hiç etkile yici olduğunu düşünmememe rağmen çok ama çok etkilendim ve beğendim .	NOUN DET ADJ NOUN ADJ NOUN VERB CCONJ ADJ NOUN ADV NOUN ADP VERB VERB ADP ADV CCONJ ADV VERB CCONJ VERB PUNCT
Yolda kaybolduğumu sandım , ama girdiğim sokaklar bana daha önce hiç görmediğim güzellikler sundu .	NOUN VERB VERB PUNCT CCONJ VERB NOUN PRON ADV ADV ADV VERB NOUN VERB PUNCT
Uzun zaman dır yapamadığım bir iş için kendimi suçlamıştım , ancak sonunda doğru bir zamanda harekete geçmenin daha iyi olduğunu anladım .	ADJ NOUN ADP VERB DET NOUN ADP PRON VERB PUNCT CCONJ ADV ADJ DET NOUN NOUN VERB ADV ADJ VERB VERB PUNCT
Hangi yıldızın beni geçmiş bir hayatımdan çağırdığını bilmiyorum , fakat onu her seferinde fark etmeden izlediğimde bir rahatlama hissediyorum .	ADJ NOUN PRON ADJ DET NOUN VERB VERB PUNCT CCONJ PRON DET NOUN NOUN VERB VERB DET VERB VERB PUNCT
Bir dağın zirvesine tırmandığımda hissettiğim yorgunluk , aşağıda ki manzaraya baktığımda tamamen anlamını yitirdi .	DET NOUN NOUN VERB VERB NOUN PUNCT ADJ ADP NOUN VERB ADV NOUN VERB PUNCT
Eski bir dostla tesadüfi bir karşılaşmanın beni hem şaşırtıp hem de sevindirdiğini anlamam , konuşmanın sonuna doğru mümkün oldu .	ADJ DET NOUN ADJ DET VERB PRON CCONJ VERB CCONJ CCONJ VERB VERB PUNCT VERB ADJ ADP ADJ VERB PUNCT
Yağmur altında yürürken hissettiğim huzur , şemsiyem olmamasına rağmen içimde beliren sıcak bir hisle açıklanabilir gibi görünüyor .	NOUN ADJ VERB VERB NOUN PUNCT NOUN VERB ADP ADJ VERB ADJ DET NOUN VERB ADP VERB PUNCT
Arkadaşımın hediye ettiği kitap tam da okumak istediğim türde ydi .	NOUN NOUN VERB NOUN ADV CCONJ VERB VERB NOUN AUX PUNCT
Bu kadar kötü bir gün geçirdiğimi hatırlamıyorum .	PRON ADP ADJ DET NOUN VERB VERB PUNCT
Yağmur tüm planlarımı alt üst etti .	NOUN DET NOUN ADJ NOUN VERB PUNCT
Onun söyledikleri beni derinden üzdü .	PRON VERB PRON ADJ VERB PUNCT
Her şey giderek daha karmaşık hale geliyor .	DET NOUN VERB ADV ADJ NOUN VERB PUNCT
Bu sessizlik , içimde derin bir boşluk yaratıyor .	DET NOUN PUNCT ADJ ADJ DET NOUN VERB PUNCT
Çabalarımın karşılığını bir türlü alamıyorum .	NOUN NOUN NUM ADJ VERB PUNCT
Etrafımda ki insanlar sürekli şikayet ediyor .	NOUN ADP NOUN ADV NOUN VERB PUNCT
Bu kadar kötü bir film izlediğimi hatırlamıyorum .	PRON ADP ADJ DET NOUN VERB VERB PUNCT
Yaptığım hataların yükü çok ağır geliyor .	VERB NOUN NOUN ADV ADJ VERB PUNCT
Her geçen gün işler daha da zorlaşıyor .	DET ADJ NOUN NOUN ADV CCONJ VERB PUNCT
Beni dinlememesi gerçekten kırıcı ydı .	PRON VERB ADV ADJ AUX PUNCT
Sürekli yanlış anlaşılmaktan yoruldum .	ADV ADJ VERB VERB PUNCT
Her şey üst üste geliyor , dayanamıyorum .	DET NOUN ADJ ADJ VERB PUNCT VERB PUNCT
Bütün umutlarım bir anda suya düştü .	ADJ NOUN DET NOUN NOUN VERB PUNCT
Bu kadar adaletsiz bir durum olamaz .	PRON ADP ADJ DET NOUN VERB PUNCT
Etrafımda ki insanlar çok bencil davranıyor .	NOUN ADP NOUN ADV ADJ VERB PUNCT
Hayat , bazen katlanılması çok zor hale geliyor .	NOUN PUNCT ADV VERB ADV ADJ NOUN VERB PUNCT
Bu soğuk hava beni çok rahatsız ediyor .	DET ADJ NOUN PRON ADV ADJ VERB PUNCT
Her şey tam tersine gidiyor , moralim bozuluyor .	DET NOUN ADV ADJ VERB PUNCT NOUN VERB PUNCT
Bu durum beni oldukça çaresiz hissettiriyor .	DET NOUN PRON ADV ADJ VERB PUNCT
Kendimi ifade edemediğim için üzgünüm .	PRON NOUN VERB ADP VERB PUNCT
Etrafımda ki enerji beni tüketiyor .	NOUN ADP NOUN PRON VERB PUNCT
Her çaba sonuçsuz kalıyor gibi hissediyorum .	DET NOUN ADJ VERB ADP VERB PUNCT
Bu tür eleştiriler moralimi çok bozuyor .	DET NOUN NOUN NOUN ADV VERB PUNCT
Emeğimin karşılığını görememek çok can sıkıcı .	NOUN NOUN VERB ADV NOUN ADJ PUNCT
Yine aynı hataları yapmış olmaktan bıktım .	ADV ADJ NOUN VERB VERB VERB PUNCT
Her şey daha iyiye gideceğine daha kötüye gidiyor .	DET NOUN ADV ADJ VERB ADV NOUN VERB PUNCT
Bu kadar yalnız hissettiğim bir zaman olmamıştı .	PRON ADP ADV VERB DET NOUN VERB PUNCT
Hatalarımın bede li çok ağır oluyor .	NOUN NOUN ADP ADV ADJ VERB PUNCT
Etrafımda ki destek eksikliği beni üzüyor .	NOUN ADP NOUN NOUN PRON VERB PUNCT
Bu kadar olumsuzluk arasında ne yapacağımı bilemiyorum .	DET ADP NOUN ADJ PRON VERB VERB PUNCT
I ̇ nsanların bu kadar anlayışsız olması gerçekten üzücü .	NOUN PUNCT NOUN DET ADP ADJ VERB ADV ADJ PUNCT
Tüm çabalarım boşa gitmiş gibi hissediyorum .	DET NOUN NOUN VERB ADP VERB PUNCT
Sürekli aynı problemleri yaşamaktan yoruldum .	ADV ADJ NOUN VERB VERB PUNCT
Hayatımda hiçbir şey yolunda gitmiyor .	ADJ DET NOUN NOUN VERB PUNCT
Bu kadar başarısız hissetmek çok yıprat ıcı .	PRON ADP ADJ VERB ADJ VERB ADP PUNCT
Kendimi yetersiz hissetmek beni derinden etkiliyor .	PRON ADJ VERB PRON ADJ VERB PUNCT
Bu kadar bir atmosferde motive olmak imkan sız .	DET ADP DET NOUN ADJ VERB NOUN ADP PUNCT
Etrafımda ki insanların ilgisizliği beni çok kırıyor .	NOUN ADP NOUN NOUN PRON ADV VERB PUNCT
Bu kadar kötü bir haber duymayı beklemiyordum .	PRON ADP ADJ DET NOUN VERB VERB PUNCT
Sürekli reddedilmek özgüvenimi zedeliyor .	ADV VERB NOUN VERB PUNCT
Tüm uğraşlarıma rağmen bir ilerleme kaydedemiyorum .	DET NOUN ADP DET VERB VERB PUNCT
Bu karanlık havalar moralimi çok bozuyor .	DET ADJ NOUN NOUN ADV VERB PUNCT
Etrafımda ki gürültü beni fazlasıyla rahatsız ediyor .	NOUN ADP NOUN PRON ADV ADJ VERB PUNCT
Hep aynı sıkıcı döngü içinde yaşıyorum .	ADV ADJ ADJ NOUN ADJ VERB PUNCT
I ̇ nsanların bencilliği beni çok hayal kırıklığına uğratıyor .	NOUN PROPN NOUN NOUN PRON ADV NOUN NOUN VERB PUNCT
Her şey üzerine geliyor gibi hissediyorum .	DET NOUN NOUN VERB ADP VERB PUNCT
Bu kadar stres li olmak fiziksel olarak da etkiliyor .	DET ADP NOUN ADP VERB ADJ ADP CCONJ VERB PUNCT
Hayatın adaletsizliğiyle yüzleşmek çok zor .	NOUN NOUN VERB ADV ADJ PUNCT
Hatalarımın bedelini bu kadar ağır ödemek haksızlık .	NOUN NOUN PRON ADP ADJ VERB NOUN PUNCT
Etrafımda ki insanların ilgisizliği içimi acıtıyor .	NOUN ADP NOUN NOUN ADJ VERB PUNCT
Her yeni gün aynı sıkıntılarla başlıyor .	DET ADJ NOUN ADJ NOUN VERB PUNCT
Bu kadar kötü bir iş ortamında çalışmak çok zor .	DET ADP ADJ DET NOUN NOUN VERB ADV ADJ PUNCT
Kimse beni anlamıyor gibi hissediyorum .	NOUN PRON VERB ADP VERB PUNCT
Her kararımda yanlış yaptığımı düşünüyorum .	DET NOUN ADJ VERB VERB PUNCT
Bu kadar yalnız hissetmek çok zorla yıcı .	PRON ADP ADV VERB ADV VERB ADP PUNCT
Sürekli bir eksiklik hissiyle yaşıyorum .	ADV DET NOUN NOUN VERB PUNCT
Her şey giderek daha kötüye gidiyor .	DET NOUN VERB ADV NOUN VERB PUNCT
Bu kadar büyük bir hayal kırıklığını beklemiyordum .	PRON ADP ADJ DET NOUN NOUN VERB PUNCT
Her şey üzerine geliyor gibi hissediyorum .	DET NOUN NOUN VERB ADP VERB PUNCT
Hayatın bu kadar acımasız olabileceğini düşünmemiştim .	NOUN DET ADP ADJ VERB VERB PUNCT
Bir türlü mutluluğu yakalayamıyorum .	NUM ADJ NOUN VERB PUNCT
Her şey daha da karmaşık bir hale geliyor .	DET NOUN ADV CCONJ ADJ DET NOUN VERB PUNCT
Kendimi ifade edemediğim için sürekli üzülüyorum .	PRON NOUN VERB ADP ADV VERB PUNCT
I ̇ nsanların bu kadar anlayışsız olması can sıkıcı .	NOUN PUNCT NOUN DET ADP ADJ VERB NOUN ADJ PUNCT
Her fırsatta bir engel çıkıyor .	DET NOUN DET NOUN VERB PUNCT
Bu kadar yalnız hissettiğim bir dönemde yim .	PRON ADP ADV VERB DET NOUN AUX PUNCT
Tüm çabalarım sonuçsuz kalıyor .	DET NOUN ADJ VERB PUNCT
Her şey üst üste gelince ne yapacağımı bilemiyorum .	DET NOUN ADJ ADJ VERB PRON VERB VERB PUNCT
I ̇ nsanların ilgisizliği beni derinden etkiliyor .	NOUN PROPN NOUN NOUN PRON ADJ VERB PUNCT
Kendimi hep yetersiz hissetmek çok üzücü .	PRON ADV ADJ VERB ADV ADJ PUNCT
Etrafımda ki sürekli olumsuzluk beni yoruyor .	NOUN ADP ADV NOUN PRON VERB PUNCT
Hatalarımın yükü artık taşınamaz hale geldi .	NOUN NOUN ADV VERB NOUN VERB PUNCT
Sürekli bir şeyler ters gidiyor gibi hissediyorum .	ADV DET NOUN ADJ VERB ADP VERB PUNCT
Bir türlü rahat bir nefes alamıyorum .	NUM ADJ ADJ DET NOUN VERB PUNCT
Bu kadar bir ortamda mutlu olmak imkan sız .	DET ADP DET NOUN ADJ VERB NOUN ADP PUNCT
I ̇ nsanların söyledikleri beni derinden yaralıyor .	NOUN PUNCT NOUN VERB PRON ADJ VERB PUNCT
Hep aynı döngüde sıkışıp kalmış gibi hissediyorum .	ADV ADJ NOUN VERB VERB ADP VERB PUNCT
Bugün her şey ters gidiyor ve bu kadar kötü bir gün geçirdiğimi hatırlamıyorum .	NOUN DET NOUN ADJ VERB CCONJ PRON ADP ADJ DET NOUN VERB VERB PUNCT
Yağmur yağdığı için bütün planlarım alt üst oldu ve dışarı çıkamadım .	NOUN VERB ADP ADJ NOUN ADJ ADJ VERB CCONJ NOUN VERB PUNCT
Onun bana söyledikleri beni derinden etkiledi ve çok üzdü .	PRON PRON VERB PRON ADJ VERB CCONJ ADV VERB PUNCT
Hayatım giderek daha karmaşık hale geliyor ve içinden çıkamıyorum .	NOUN VERB ADV ADJ NOUN VERB CCONJ ADJ VERB PUNCT
Bu sessizlik içimde derin bir boşluk yaratıyor ve kendimi yalnız hissediyorum .	DET NOUN ADJ ADJ DET NOUN VERB CCONJ PRON ADV VERB PUNCT
Çabalarımın karşılığını alamamak gerçekten moralimi bozuyor .	NOUN NOUN VERB ADV NOUN VERB PUNCT
Etrafımda ki insanlar sürekli şikayet ediyor ve bu beni çok rahatsız ediyor .	NOUN ADP NOUN ADV NOUN VERB CCONJ PRON PRON ADV ADJ VERB PUNCT
Bu kadar kötü bir film izlediğimi hatırlamıyorum ve zamanımı boşa harcadım .	PRON ADP ADJ DET NOUN VERB VERB CCONJ NOUN NOUN VERB PUNCT
Yaptığım hataların yükü çok ağır geliyor ve kendimi suçlu hissediyorum .	VERB NOUN NOUN ADV ADJ VERB CCONJ PRON ADJ VERB PUNCT
Her geçen gün işler daha da zorlaşıyor ve bu durum beni bunaltıyor .	DET ADJ NOUN NOUN ADV CCONJ VERB CCONJ DET NOUN PRON VERB PUNCT
Beni dinlememesi gerçekten çok kırıcı ydı ve üzüldüm .	PRON VERB ADV ADV ADJ AUX CCONJ VERB PUNCT
Sürekli yanlış anlaşılmaktan yoruldum ve ne yapacağımı bilemiyorum .	ADV ADJ VERB VERB CCONJ PRON VERB VERB PUNCT
Her şey üst üste geliyor ve artık dayanamıyorum .	DET NOUN ADJ ADJ VERB CCONJ ADV VERB PUNCT
Bütün umutlarım bir anda suya düştü ve çok hayal kırıklığına uğradım .	ADJ NOUN DET NOUN NOUN VERB CCONJ ADV NOUN NOUN VERB PUNCT
Bu kadar adaletsiz bir durum olamaz ve kendimi çaresiz hissediyorum .	DET ADP ADJ DET NOUN VERB CCONJ PRON ADJ VERB PUNCT
Etrafımda ki insanlar çok bencil davranıyor ve bu durum beni üzüyor .	NOUN ADP NOUN ADV ADJ VERB CCONJ DET NOUN PRON VERB PUNCT
Hayat bazen katlanılması çok zor hale geliyor ve ne yapacağımı bilemiyorum .	NOUN ADV VERB ADV ADJ NOUN VERB CCONJ PRON VERB VERB PUNCT
Bu soğuk hava beni çok rahatsız ediyor ve dışarı çıkmak istemiyorum .	DET ADJ NOUN PRON ADV ADJ VERB CCONJ NOUN VERB VERB PUNCT
Her şey tam tersine gidiyor ve moralim çok bozuluyor .	DET NOUN ADV ADJ VERB CCONJ NOUN ADV VERB PUNCT
Bu durum beni oldukça çaresiz hissettiriyor ve çıkış yolu bulamıyorum .	DET NOUN PRON ADV ADJ VERB CCONJ NOUN NOUN VERB PUNCT
Kendimi ifade edemediğim için çok üzgünüm ve bu durum beni rahatsız ediyor .	PRON NOUN VERB ADP ADV VERB CCONJ DET NOUN PRON ADJ VERB PUNCT
Etrafımda ki enerji beni tüketiyor ve yorgun hissediyorum .	NOUN ADP NOUN PRON VERB CCONJ ADJ VERB PUNCT
Her çaba sonuçsuz kalıyor gibi hissediyorum ve motivasyonumu kaybediyorum .	DET NOUN ADJ VERB ADP VERB CCONJ NOUN VERB PUNCT
Bu tür eleştiriler moralimi çok bozuyor ve kendimi değersiz hissediyorum .	DET NOUN NOUN NOUN ADV VERB CCONJ PRON ADJ VERB PUNCT
Emeğimin karşılığını görememek gerçekten çok can sıkıcı .	NOUN NOUN VERB ADV ADV NOUN ADJ PUNCT
Yine aynı hataları yapmış olmaktan bıktım ve kendime kızıyorum .	ADV ADJ NOUN VERB VERB VERB CCONJ PRON VERB PUNCT
Her şey daha iyiye gideceğine daha kötüye gidiyor ve bu durum beni üzüyor .	DET NOUN ADV ADJ VERB ADV NOUN VERB CCONJ DET NOUN PRON VERB PUNCT
Bu kadar yalnız hissettiğim bir zaman olmamıştı ve çok üzgünüm .	PRON ADP ADV VERB DET NOUN VERB CCONJ ADV NOUN PUNCT
Hatalarımın bede li çok ağır oluyor ve bu durum beni yıpratıyor .	NOUN NOUN ADP ADV ADJ VERB CCONJ DET NOUN PRON VERB PUNCT
Etrafımda ki destek eksikliği beni üzüyor ve yalnız hissettiriyor .	NOUN ADP NOUN NOUN PRON VERB CCONJ ADV VERB PUNCT
Bu kadar olumsuzluk arasında ne yapacağımı bilemiyorum ve çaresiz hissediyorum .	DET ADP NOUN ADJ PRON VERB VERB CCONJ ADJ VERB PUNCT
I ̇ nsanların bu kadar anlayışsız olması gerçekten üzücü ve moral bozucu .	NOUN PUNCT NOUN DET ADP ADJ VERB ADV ADJ CCONJ NOUN ADJ PUNCT
Tüm çabalarım boşa gitmiş gibi hissediyorum ve bu durum beni çok yoruyor .	DET NOUN NOUN VERB ADP VERB CCONJ DET NOUN PRON ADV VERB PUNCT
Sürekli aynı problemleri yaşamaktan yoruldum ve çözüm bulamıyorum .	ADV ADJ NOUN VERB VERB CCONJ NOUN VERB PUNCT
Hayatımda hiçbir şey yolunda gitmiyor ve ne yapacağımı bilemiyorum .	NOUN DET NOUN NOUN VERB CCONJ PRON VERB VERB PUNCT
Bu kadar başarısız hissetmek gerçekten çok yıprat ıcı ve moral bozucu .	PRON ADP ADJ VERB ADV ADJ VERB ADP CCONJ NOUN ADJ PUNCT
Kendimi yetersiz hissetmek beni derinden etkiliyor ve özgüvenimi kaybediyorum .	PRON ADJ VERB PRON ADJ VERB CCONJ NOUN VERB PUNCT
Bu kadar bir atmosferde motive olmak gerçekten imkansız .	DET ADP DET NOUN ADJ VERB ADV ADJ PUNCT
Etrafımda ki insanların ilgisizliği beni çok kırıyor ve üzgün hissettiriyor .	NOUN ADP NOUN NOUN PRON ADV VERB CCONJ ADJ VERB PUNCT
Bu kadar kötü bir haber duymayı beklemiyordum ve şok oldum .	PRON ADP ADJ DET NOUN VERB VERB CCONJ NOUN VERB PUNCT
Sürekli reddedilmek özgüvenimi zedeliyor ve moralimi bozuyor .	ADV VERB NOUN VERB CCONJ NOUN VERB PUNCT
Tüm uğraşlarıma rağmen bir ilerleme kaydedemiyorum ve bu durum beni çok üzüyor .	DET NOUN ADP DET VERB VERB CCONJ DET NOUN PRON ADV VERB PUNCT
Bu karanlık havalar moralimi çok bozuyor ve içimi karartıyor .	DET ADJ NOUN NOUN ADV VERB CCONJ ADJ VERB PUNCT
Etrafımda ki gürültü beni fazlasıyla rahatsız ediyor ve sinir bozucu .	NOUN ADP NOUN PRON ADV ADJ VERB CCONJ NOUN ADJ PUNCT
Hep aynı sıkıcı döngü içinde yaşıyorum ve bu durumdan çok yoruldum .	ADV ADJ ADJ NOUN ADJ VERB CCONJ DET NOUN ADV VERB PUNCT
I ̇ nsanların bencilliği beni çok hayal kırıklığına uğratıyor ve üzgün hissediyorum .	NOUN PROPN NOUN NOUN PRON ADV NOUN NOUN VERB CCONJ ADJ VERB PUNCT
Her şey üzerine geliyor gibi hissediyorum ve bu durum beni çok bunaltıyor .	DET NOUN NOUN VERB ADP VERB CCONJ DET NOUN PRON ADV VERB PUNCT
Bu kadar stres li olmak fiziksel olarak da beni etkiliyor ve sağlığımı bozuyor .	DET ADP NOUN ADP VERB ADJ ADP CCONJ PRON VERB CCONJ NOUN VERB PUNCT
Hayatın adaletsizliğiyle yüzleşmek gerçekten çok zor ve moral bozucu .	NOUN NOUN VERB ADV ADV ADJ CCONJ NOUN ADJ PUNCT
Hatalarımın bedelini bu kadar ağır ödemek gerçekten haksızlık .	NOUN NOUN PRON ADP ADJ VERB ADV NOUN PUNCT
Etrafımda ki insanların ilgisizliği içimi acıtıyor ve yalnız hissettiriyor .	NOUN ADP NOUN NOUN ADJ VERB CCONJ ADV VERB PUNCT
Her yeni gün aynı sıkıntılarla başlıyor ve bu durum beni çok yoruyor .	DET ADJ NOUN ADJ NOUN VERB CCONJ DET NOUN PRON ADV VERB PUNCT
Bu kadar kötü bir iş ortamında çalışmak gerçekten çok zor ve moral bozucu .	DET ADP ADJ DET NOUN NOUN VERB ADV ADV ADJ CCONJ NOUN ADJ PUNCT
Kimse beni anlamıyor gibi hissediyorum ve bu durum beni çok üzüyor .	NOUN PRON VERB ADP VERB CCONJ DET NOUN PRON ADV VERB PUNCT
Her kararımda yanlış yaptığımı düşünüyorum ve kendime güvenim kalmadı .	DET NOUN ADJ VERB VERB CCONJ PRON NOUN VERB PUNCT
Bu kadar yalnız hissetmek gerçekten çok zorla yıcı ve moral bozucu .	PRON ADP ADV VERB ADV ADV VERB ADP CCONJ NOUN ADJ PUNCT
Sürekli bir eksiklik hissiyle yaşıyorum ve bu durum beni çok üzüyor .	ADV DET NOUN NOUN VERB CCONJ DET NOUN PRON ADV VERB PUNCT
Her şey giderek daha kötüye gidiyor ve bu durum beni çok bunaltıyor .	DET NOUN VERB ADV NOUN VERB CCONJ DET NOUN PRON ADV VERB PUNCT
Bu kadar büyük bir hayal kırıklığını beklemiyordum ve çok üzüldüm .	PRON ADP ADJ DET NOUN NOUN VERB CCONJ ADV VERB PUNCT
Her şey üzerine geliyor gibi hissediyorum ve bu durum beni çok bunaltıyor .	DET NOUN NOUN VERB ADP VERB CCONJ DET NOUN PRON ADV VERB PUNCT
Hayatın bu kadar acımasız olabileceğini düşünmemiştim ve şok oldum .	NOUN DET ADP ADJ VERB VERB CCONJ NOUN VERB PUNCT
Bir türlü mutluluğu yakalayamıyorum ve bu durum beni çok üzüyor .	NUM ADJ NOUN VERB CCONJ DET NOUN PRON ADV VERB PUNCT
Her şey daha da karmaşık bir hale geliyor ve içinden çıkamıyorum .	DET NOUN ADV CCONJ ADJ DET NOUN VERB CCONJ ADJ VERB PUNCT
Kendimi ifade edemediğim için sürekli üzülüyorum ve bu durum beni rahatsız ediyor .	PRON NOUN VERB ADP ADV VERB CCONJ DET NOUN PRON ADJ VERB PUNCT
I ̇ nsanların bu kadar anlayışsız olması gerçekten çok can sıkıcı .	NOUN PUNCT NOUN DET ADP ADJ VERB ADV ADV NOUN ADJ PUNCT
Her fırsatta bir engel çıkıyor ve bu durum beni çok üzüyor .	DET NOUN DET NOUN VERB CCONJ DET NOUN PRON ADV VERB PUNCT
Bu kadar yalnız hissettiğim bir dönemde yim ve bu durum beni çok rahatsız ediyor .	PRON ADP ADV VERB DET NOUN AUX CCONJ DET NOUN PRON ADV ADJ VERB PUNCT
Tüm çabalarım sonuçsuz kalıyor ve bu durum beni çok üzüyor .	DET NOUN ADJ VERB CCONJ DET NOUN PRON ADV VERB PUNCT
Her şey üst üste gelince ne yapacağımı bilemiyorum ve çaresiz hissediyorum .	DET NOUN ADJ ADJ VERB PRON VERB VERB CCONJ ADJ VERB PUNCT
I ̇ nsanların ilgisizliği beni derinden etkiliyor ve yalnız hissettiriyor .	NOUN PROPN NOUN NOUN PRON ADJ VERB CCONJ ADV VERB PUNCT
Kendimi hep yetersiz hissetmek gerçekten çok üzücü .	PRON ADV ADJ VERB ADV ADV ADJ PUNCT
Etrafımda ki sürekli olumsuzluk beni yoruyor ve yıpratıyor .	NOUN ADP ADV NOUN PRON VERB CCONJ VERB PUNCT
Hatalarımın yükü artık taşınamaz hale geldi ve bu durum beni çok üzüyor .	NOUN NOUN ADV VERB NOUN VERB CCONJ DET NOUN PRON ADV VERB PUNCT
Sürekli bir şeyler ters gidiyor gibi hissediyorum ve moralim bozuluyor .	ADV DET NOUN ADJ VERB ADP VERB CCONJ NOUN VERB PUNCT
Bir türlü rahat bir nefes alamıyorum ve bu durum beni çok yoruyor .	NUM ADJ ADJ DET NOUN VERB CCONJ DET NOUN PRON ADV VERB PUNCT
Bu kadar bir ortamda mutlu olmak gerçekten imkansız .	DET ADP DET NOUN ADJ VERB ADV ADJ PUNCT
I ̇ nsanların söyledikleri beni derinden yaralıyor ve üzüyor .	NOUN PUNCT NOUN VERB PRON ADJ VERB CCONJ VERB PUNCT
Hep aynı döngüde sıkışıp kalmış gibi hissediyorum ve çıkış yolu bulamıyorum .	ADV ADJ NOUN VERB VERB ADP VERB CCONJ NOUN NOUN VERB PUNCT
Hatalarım rahatsız edici ve bu durum beni çok üzüyor .	NOUN ADJ VERB CCONJ DET NOUN PRON ADV VERB PUNCT
Motivasyon eksikliği beni çok rahatsız ediyor ve iş yapma isteğim kalmıyor .	NOUN NOUN PRON ADV ADJ VERB CCONJ NOUN VERB NOUN VERB PUNCT
Başarısızlık duygusu beni derinden etkiliyor ve moralimi bozuyor .	NOUN NOUN PRON ADJ VERB CCONJ NOUN VERB PUNCT
Yalnızlık gerçekten çok zorla yıcı ve bu durum beni çok üzüyor .	NOUN ADV ADV VERB ADP CCONJ DET NOUN PRON ADV VERB PUNCT
Çabalarım yetersiz kalıyor ve bu durum beni çok üzüyor .	NOUN ADJ VERB CCONJ DET NOUN PRON ADV VERB PUNCT
Ruh hali beni tüketiyor ve yorgun hissettiriyor .	NOUN NOUN PRON VERB CCONJ ADJ VERB PUNCT
Hayal kırıklığı beni derinden etkiliyor ve bu durumu atlatmakta zorlanıyorum .	NOUN NOUN PRON ADJ VERB CCONJ DET NOUN VERB VERB PUNCT
Dışlanmış hissetmek gerçekten çok can sıkıcı ve moral bozucu .	VERB VERB ADV ADJ NOUN ADJ CCONJ NOUN ADJ PUNCT
Zamanımı boşa harcıyor gibi hissediyorum ve bu durum beni çok rahatsız ediyor .	NOUN NOUN VERB ADP VERB CCONJ DET NOUN PRON ADV ADJ VERB PUNCT
Çıkmazda olmak ve bir çözüm yolu bulamamak gerçekten çok zor .	NOUN VERB CCONJ DET NOUN NOUN VERB ADV ADV ADJ PUNCT
Hayatın zorluğu beni çok yıpratıyor ve enerjimi kaybediyorum .	NOUN NOUN PRON ADV VERB CCONJ NOUN VERB PUNCT
Sorunlar artmaya devam ediyor ve ben ne yapacağımı bilemiyorum .	NOUN VERB NOUN VERB CCONJ PRON PRON VERB VERB PUNCT
Mücadele etmekten yoruldum ve bu durum beni çok yıpratıyor .	NOUN VERB VERB CCONJ DET NOUN PRON ADV VERB PUNCT
Üzücü sonuçlar beni derinden etkiliyor ve moralimi bozuyor .	ADJ NOUN PRON ADJ VERB CCONJ NOUN VERB PUNCT
Kayıplar derin ve bu durum beni çok üzüyor .	NOUN ADJ CCONJ DET NOUN PRON ADV VERB PUNCT
Anlaşılmamak gerçekten çok kırıcı ve moral bozucu .	VERB ADV ADV ADJ CCONJ NOUN ADJ PUNCT
Olumsuz geri dönüşler almak beni çok üzüyor ve motivasyonumu kaybediyorum .	ADJ ADJ NOUN VERB PRON ADV VERB CCONJ NOUN VERB PUNCT
Umutsuzluk duygusu beni derinden etkiliyor ve ne yapacağımı bilemiyorum .	NOUN NOUN PRON ADJ VERB CCONJ PRON VERB VERB PUNCT
Başarısızlık acıtıyor ve kendimi değersiz hissediyorum .	NOUN VERB CCONJ PRON ADJ VERB PUNCT
Destek eksikliği beni çok yıpratıyor ve yalnız hissettiriyor .	NOUN NOUN PRON ADV VERB CCONJ ADV VERB PUNCT
Yalnızlık duygusu beni derinden etkiliyor ve moralimi bozuyor .	NOUN NOUN PRON ADJ VERB CCONJ NOUN VERB PUNCT
Her şeyin üst üste gelmesi beni çok bunaltıyor ve çaresiz hissediyorum .	DET NOUN ADJ ADJ VERB PRON ADV VERB CCONJ ADJ VERB PUNCT
Her şeyin üst üste gelmesi beni çok bunaltıyor ve çaresiz hissediyorum .	DET NOUN ADJ ADJ VERB PRON ADV VERB CCONJ ADJ VERB PUNCT
Sürekli bir şeyler ters gidiyor gibi hissediyorum ve moralim bozuluyor .	ADV DET NOUN ADJ VERB ADP VERB CCONJ NOUN VERB PUNCT
Bu kadar yalnız hissetmek gerçekten çok zorla yıcı ve moral bozucu .	PRON ADP ADV VERB ADV ADV VERB ADP CCONJ NOUN ADJ PUNCT
Hatalarımın bedelini bu kadar ağır ödemek gerçekten haksızlık .	NOUN NOUN PRON ADP ADJ VERB ADV NOUN PUNCT
Etrafımda ki insanların ilgisizliği içimi acıtıyor ve yalnız hissettiriyor .	NOUN ADP NOUN NOUN ADJ VERB CCONJ ADV VERB PUNCT
Her yeni gün aynı sıkıntılarla başlıyor ve bu durum beni çok yoruyor .	DET ADJ NOUN ADJ NOUN VERB CCONJ DET NOUN PRON ADV VERB PUNCT
Bu kadar kötü bir iş ortamında çalışmak gerçekten çok zor ve moral bozucu .	DET ADP ADJ DET NOUN NOUN VERB ADV ADV ADJ CCONJ NOUN ADJ PUNCT
Kimse beni anlamıyor gibi hissediyorum ve bu durum beni çok üzüyor .	NOUN PRON VERB ADP VERB CCONJ DET NOUN PRON ADV VERB PUNCT
Her kararımda yanlış yaptığımı düşünüyorum ve kendime güvenim kalmadı .	DET NOUN ADJ VERB VERB CCONJ PRON NOUN VERB PUNCT
Bu kadar yalnız hissetmek gerçekten çok zorla yıcı ve moral bozucu .	PRON ADP ADV VERB ADV ADV VERB ADP CCONJ NOUN ADJ PUNCT
Birlikte çalışmak her zaman daha verimli .	ADV VERB DET NOUN ADV ADJ PUNCT
Sabah güneşi insanın içini ısıtıyor .	NOUN NOUN NOUN ADJ VERB PUNCT
Hayallerimiz , geleceği şekillendirir .	NOUN PUNCT ADJ VERB PUNCT
Bir dostun omzuna yaslanmak huzur verir .	DET ADJ NOUN VERB NOUN VERB PUNCT
Etrafında ki güzelliklere odaklan , hayat daha keyif li olur .	NOUN ADP NOUN VERB PUNCT NOUN ADV NOUN ADP VERB PUNCT
Küçük bir tebessüm bile gününü aydınlatabilir .	ADJ DET NOUN ADV NOUN VERB PUNCT
Doğanın sessizliği insana huzur verir .	NOUN NOUN NOUN NOUN VERB PUNCT
Çocukların neşesi , yaşamın en güzel melodisi dir .	ADJ NOUN PUNCT NOUN ADV ADJ NOUN AUX PUNCT
Yeni bir yetenek öğrenmek heyecan ver ici .	ADJ DET NOUN VERB NOUN VERB ADP PUNCT
Sevgi , en güçlü bağ dır .	NOUN PUNCT ADV ADJ NOUN AUX PUNCT
Bir araya gelince her engeli aşabiliriz .	DET ADJ VERB DET NOUN VERB PUNCT
Mutluluk , paylaşmakla çoğalır .	NOUN PUNCT VERB VERB PUNCT
I ̇ yilik yapmak insanın ruhunu yüceltir .	NOUN PUNCT NOUN VERB NOUN NOUN VERB PUNCT
Doğanın renkleri büyüleyici dir .	NOUN NOUN ADJ AUX PUNCT
Şarkı söylemek ruhunu özgürleştirir .	NOUN VERB NOUN VERB PUNCT
Yeni başlangıçlar her zaman umut dolu dur .	ADJ NOUN DET NOUN NOUN ADJ AUX PUNCT
Bir fincan kahveyle güne güzel başlamak harika .	NUM NOUN NOUN NOUN ADJ VERB ADJ PUNCT
Sevgi dolu bir aile her şeyden değerli dir .	NOUN ADJ DET NOUN DET NOUN ADJ AUX PUNCT
Birlikte geçirilen zamanlar çok kıymetli dir .	ADP VERB NOUN ADV ADJ AUX PUNCT
Hayallerine inan , her şey mümkün olabilir .	NOUN VERB PUNCT DET NOUN ADJ VERB PUNCT
Doğanın kokusu insana huzur verir .	NOUN NOUN NOUN NOUN VERB PUNCT
Küçük şeylerle mutlu olmayı bilmek harika bir yetenek tir .	ADJ NOUN ADJ VERB VERB ADJ DET NOUN AUX PUNCT
Arkadaşlarınla geçirilen keyif li anlar unutulmaz dır .	NOUN VERB NOUN ADP NOUN ADJ AUX PUNCT
Başarı , azim ve inançla gelir .	NOUN PUNCT NOUN CCONJ NOUN VERB PUNCT
Güzel bir hikaye insanı derinden etkiler .	ADJ DET NOUN NOUN ADJ VERB PUNCT
Doğanın güzellikleri ruhumuza iyi gelir .	NOUN NOUN NOUN ADJ VERB PUNCT
Güzel bir gün geçirmek tamamen bizim elimizde .	ADJ DET NOUN VERB ADV PRON NOUN PUNCT
Birlik ve beraberlik her zaman güç katar .	NOUN CCONJ NOUN DET NOUN ADJ VERB PUNCT
Kitap okumak , bilgiyle dolu dünyalara açılan bir kapı dır .	NOUN VERB PUNCT NOUN ADJ NOUN VERB DET NOUN AUX PUNCT
Doğanın seslerini dinlemek ruhu dinginleştirir .	NOUN NOUN VERB NOUN VERB PUNCT
Hayatta en güzel şey , sevgi dolu bir kalbe sahip olmak tır .	NOUN ADV ADJ NOUN PUNCT NOUN ADJ DET NOUN NOUN VERB AUX PUNCT
Güneşin doğuşunu izlemek insanı heyecanlandırır .	NOUN NOUN VERB NOUN VERB PUNCT
Çocukların gülümsemesi dünyayı daha iyi bir yer yapar .	ADJ VERB NOUN ADV ADJ DET NOUN VERB PUNCT
Şükretmek insanı daha huzurlu kılar .	VERB NOUN ADV ADJ VERB PUNCT
Yeni yerler keşfetmek hayatı renklendirir .	ADJ NOUN VERB NOUN VERB PUNCT
Sevgiyle büyüyen her şey anlam kazanır .	NOUN VERB DET NOUN NOUN VERB PUNCT
Tatlı bir melodi ruhunu besler .	ADJ DET NOUN NOUN VERB PUNCT
Dostların varlığı en büyük zenginlik tir .	ADJ NOUN ADV ADJ NOUN AUX PUNCT
Her yeni gün , yeni bir umut taşır .	DET ADJ NOUN PUNCT ADJ DET NOUN VERB PUNCT
I ̇ nsanların gülümsemesi , etrafı aydınlatır .	NOUN PUNCT NOUN VERB PUNCT NOUN VERB PUNCT
Doğa , bize yaşamın ne kadar güzel olduğunu hatırlatır .	NOUN PUNCT PRON NOUN PRON ADP ADJ VERB VERB PUNCT
Her zaman umut etmekten vazgeçme .	DET NOUN NOUN VERB VERB PUNCT
Bir başarıyı paylaşmak , mutluluğu ikiye katlar .	DET NOUN VERB PUNCT NOUN NUM VERB PUNCT
Samimi bir sohbet insanın ruhunu rahatlatır .	ADJ DET NOUN NOUN NOUN VERB PUNCT
Yaşam , küçük güzellikleri fark ettiğinde daha anlam lı olur .	NOUN PUNCT ADJ NOUN NOUN VERB ADV NOUN ADP VERB PUNCT
Hayatta en büyük güç , sevgiyle yapılan işlerde gizli dir .	NOUN ADV ADJ ADJ PUNCT NOUN VERB NOUN ADJ AUX PUNCT
Yağmurun ardından çıkan gökkuşağı umut verir .	NOUN NOUN VERB NOUN NOUN VERB PUNCT
Sanat , insanın ruhunu özgürleştirir .	NOUN PUNCT NOUN NOUN VERB PUNCT
I ̇ çten bir teşekkür , kalpleri birbirine yaklaştırır .	NOUN PROPN ADP DET NOUN PUNCT NOUN PRON VERB PUNCT
Hayata olumlu bakış açısıyla yaklaşmak her şeyi değiştirir .	NOUN ADJ NOUN NOUN VERB DET NOUN VERB PUNCT
Bir çiçeğin açışını izlemek ruhunu dinlendirir .	DET NOUN NOUN VERB NOUN VERB PUNCT
Mutlu bir kahvaltı güne başlamanı sağlar .	ADJ DET NOUN NOUN VERB VERB PUNCT
Küçük başarılar , büyük zaferlerin temeli dir .	ADJ NOUN PUNCT ADJ NOUN ADJ AUX PUNCT
Çocukların hayal gücü dünyaya ilham verir .	NOUN NOUN ADJ NOUN NOUN VERB PUNCT
Her gün yeni bir şey öğrenmek hayatı güzelleştirir .	DET NOUN ADJ NUM NOUN VERB NOUN VERB PUNCT
Baharın gelişiyle doğanın uyanışı insanı heyecanlandırır .	NOUN NOUN NOUN NOUN NOUN VERB PUNCT
Etrafında kilere nazik davranmak her zaman güzeldir .	NOUN ADP ADJ VERB DET NOUN VERB PUNCT
Güzel bir söz insanın gününü aydınlatabilir .	ADJ DET NOUN NOUN NOUN VERB PUNCT
Doğanın kokusu insana huzur verir .	NOUN NOUN NOUN NOUN VERB PUNCT
Yıldızlı bir gece insana ilham verir .	ADJ DET NOUN NOUN NOUN VERB PUNCT
Mutlu bir yaşam için sevgi en önem li kaynak tır .	ADJ DET NOUN ADP NOUN ADV NOUN ADP NOUN AUX PUNCT
Bir arkadaşın desteği en zor zamanları kolaylaştırır .	DET NOUN NOUN ADV ADJ NOUN VERB PUNCT
Hayatta en değerli şey , sevdiklerinle birlikte olmak tır .	NOUN ADV ADJ NOUN PUNCT NOUN ADV VERB AUX PUNCT
Şarkılar , duygularımızı en iyi ifade etmenin yollarından biri dir .	NOUN PUNCT NOUN ADV ADJ NOUN VERB NOUN PRON AUX PUNCT
Hayat , neşe ve sevgi dolu bir yürekle daha güzeldir .	NOUN PUNCT NOUN CCONJ NOUN ADJ DET NOUN ADV VERB PUNCT
Başarı için ilk adım , hayal etmek tir .	NOUN ADP ADJ NOUN PUNCT NOUN VERB AUX PUNCT
Her yeni gün , yeni bir şans demek tir .	DET ADJ NOUN PUNCT ADJ DET NOUN VERB AUX PUNCT
Evin sıcaklığı , huzurun en güzel tanımı dır .	NOUN NOUN PUNCT NOUN ADV ADJ NOUN AUX PUNCT
Sevdiğin biriyle yapılan yürüyüşler daha anlamlı dır .	VERB PRON VERB NOUN ADV ADJ AUX PUNCT
Birlikte geçirilen her an , paha biçilemez dir .	ADP VERB DET NOUN PUNCT NOUN VERB AUX PUNCT
Doğa yürüyüşleri insana enerji verir .	NOUN NOUN NOUN NOUN VERB PUNCT
Tatlı bir rüzgar ruhunu canlandırır .	ADJ DET NOUN NOUN VERB PUNCT
Her gün , kendini geliştirmek için bir fırsat tır .	DET NOUN PUNCT PRON VERB ADP DET NOUN AUX PUNCT
Yaşam , sevgi dolu bir yürekle daha anlamlı dır .	NOUN PUNCT NOUN ADJ DET NOUN ADV ADJ AUX PUNCT
Başarıya ulaşmak için her zaman bir yol var dır .	NOUN VERB ADP DET NOUN DET NOUN ADJ AUX PUNCT
Yeni bir başlangıç , yeni umutlar getirir .	ADJ DET NOUN PUNCT ADJ NOUN VERB PUNCT
Dostlar , yaşam yolculuğumuzda ki en kıymet li yol arkadaşları dır .	NOUN PUNCT NOUN NOUN ADP ADV NOUN ADP NOUN NOUN AUX PUNCT
Hayata umutla bakmak her şeyi kolaylaştırır .	NOUN NOUN VERB DET NOUN VERB PUNCT
Sevdiklerinle birlikte geçirilen anlar unutulmaz dır .	NOUN ADP VERB NOUN VERB AUX PUNCT
Her sabah , yeni bir başlangıcın habercisi dir .	DET NOUN PUNCT ADJ DET NOUN NOUN AUX PUNCT
Yaşam , keşfetmeye değer bir macera dır .	NOUN PUNCT VERB NOUN DET NOUN AUX PUNCT
Doğanın güzelliklerini keşfetmek mutluluğu artırır .	NOUN NOUN VERB NOUN VERB PUNCT
Başarı , sabır ve özveriyle gelir .	NOUN PUNCT NOUN CCONJ NOUN VERB PUNCT
Her güzel gün , yeni bir hikaye yazar .	DET ADJ NOUN PUNCT ADJ DET NOUN VERB PUNCT
Sevgi dolu bir söz , karanlıkları aydınlatabilir .	NOUN ADJ DET NOUN PUNCT NOUN VERB PUNCT
Güzel anılar biriktirmek hayatı zenginleştirir .	ADJ NOUN VERB NOUN VERB PUNCT
Her yeni gün , bir armağan dır .	DET ADJ NOUN PUNCT DET NOUN AUX PUNCT
Hayal gücü , yaşamın sınırsız olasılıklarını keşfetmek tir .	NOUN ADJ PUNCT NOUN ADJ NOUN VERB AUX PUNCT
Şimdiye kadar yaşadığın en güzel gün , bugün dür .	NOUN ADP VERB ADV ADJ NOUN PUNCT NOUN AUX PUNCT
Sevgi dolu bir bakış her şeyi değiştirebilir .	NOUN ADJ DET NOUN DET NOUN VERB PUNCT
Mutluluk , içimizde saklı bir cevher dir .	NOUN PUNCT ADJ ADJ DET NOUN AUX PUNCT
Şefkat göstermek insanı yüceltir .	NOUN VERB NOUN VERB PUNCT
Çiçeklerin açışı , doğanın bir mucizesi dir .	NOUN NOUN PUNCT NOUN DET NOUN AUX PUNCT
Gülümsemek , kalpleri ısıtır .	VERB PUNCT NOUN VERB PUNCT
Kitaplar , bilginin anahtarı dır .	NOUN PUNCT NOUN NOUN AUX PUNCT
Doğanın müziği , ruhumuzu besler .	NOUN NOUN PUNCT NOUN VERB PUNCT
Hayata bakmak , her günü güzelleştirir .	NOUN VERB PUNCT DET NOUN VERB PUNCT
Paylaşmak , sevgiyi büyütür .	VERB PUNCT NOUN VERB PUNCT
I ̇ nanç , insanı güçlü kılar .	NOUN PUNCT NOUN PUNCT NOUN ADJ VERB PUNCT
Huzurlu bir yürüyüş , ruhunuza iyi gelir .	ADJ DET NOUN PUNCT NOUN ADJ VERB PUNCT
Güne başlamak , başarı getirir .	NOUN VERB PUNCT NOUN VERB PUNCT
Yeni dostluklar , hayatı zenginleştirir .	ADJ NOUN PUNCT NOUN VERB PUNCT
Doğa , bize huzur verir .	NOUN PUNCT PRON NOUN VERB PUNCT
Hayat , keşfedilmeyi bekleyen bir hazine .	NOUN PUNCT VERB VERB DET NOUN PUNCT
I ̇ yilik yapmak , ruhu besler .	NOUN PUNCT NOUN VERB PUNCT NOUN VERB PUNCT
Sevgiyle büyüyen her şey güzelleşir .	NOUN VERB DET NOUN VERB PUNCT
Başarı , sabırla gelir .	NOUN PUNCT NOUN VERB PUNCT
Neşeli anılar , ömür boyu kalır .	ADJ NOUN PUNCT NOUN ADJ VERB PUNCT
Gözyaşları bile bazen iyileştirir .	NOUN ADV ADV VERB PUNCT
Düşünmek , hayatı kolaylaştırır .	VERB PUNCT NOUN VERB PUNCT
Sevdiğinle geçirilen zaman , en değerli zaman dır .	ADJ VERB NOUN PUNCT ADV ADJ NOUN AUX PUNCT
Küçük jestler , büyük mutluluklar yaratır .	ADJ NOUN PUNCT ADJ NOUN VERB PUNCT
Gülmek , en güzel ilacımız dır .	VERB PUNCT ADV ADJ NOUN AUX PUNCT
Hayaller , geleceği şekillendirir .	NOUN PUNCT ADJ VERB PUNCT
Bir dostun yanında olmak , huzur verir .	DET ADJ ADJ VERB PUNCT NOUN VERB PUNCT
Düşünce , hayatı renklendirir .	NOUN PUNCT NOUN VERB PUNCT
Güzel bir sabah , harika bir günün habercisi dir .	ADJ DET NOUN PUNCT ADJ DET NOUN NOUN AUX PUNCT
Bir gülüş , dünyayı değiştirir .	DET NOUN PUNCT NOUN VERB PUNCT
Sevgi dolu bir kalp , en güzel hazine dir .	NOUN ADJ DET NOUN PUNCT ADV ADJ NOUN AUX PUNCT
Yeni bir yetenek , heyecan verir .	ADJ DET NOUN PUNCT NOUN VERB PUNCT
Başarı , azimle gelir .	NOUN PUNCT NOUN VERB PUNCT
Birlikte olmak , güç katar .	ADP VERB PUNCT ADJ VERB PUNCT
Mutlu bir çocuk , en güzel melodi dir .	ADJ DET NOUN PUNCT ADV ADJ NOUN AUX PUNCT
Doğanın sessizliği , huzur verir .	NOUN NOUN PUNCT NOUN VERB PUNCT
Küçük mutluluklar , hayatı güzelleştirir .	ADJ NOUN PUNCT NOUN VERB PUNCT
Güneşin doğuşu , yeni umutlar getirir .	NOUN NOUN PUNCT ADJ NOUN VERB PUNCT
I ̇ yilik , dünyayı değiştirir .	NOUN PUNCT ADP PUNCT NOUN VERB PUNCT
Sevgi , en güçlü bağ dır .	NOUN PUNCT ADV ADJ NOUN AUX PUNCT
Başarı , inançla gelir .	NOUN PUNCT NOUN VERB PUNCT
Bir dostun omzunda huzur bulmak , paha biçilmez dir .	DET ADJ NOUN NOUN VERB PUNCT NOUN VERB AUX PUNCT
Doğa yürüyüşleri , enerjimizi tazeler .	NOUN NOUN PUNCT NOUN VERB PUNCT
Şarkılar , ruhumuzu besler .	NOUN PUNCT NOUN VERB PUNCT
Mutlu bir an , ömür boyu kalır .	ADJ DET NOUN PUNCT NOUN ADJ VERB PUNCT
Bir çiçeğin açması , mucize dir .	DET NOUN VERB PUNCT NOUN AUX PUNCT
Başarı , emekle gelir .	NOUN PUNCT NOUN VERB PUNCT
Güzel bir hikaye , derin izler bırakır .	ADJ DET NOUN PUNCT ADJ NOUN VERB PUNCT
Sevgi dolu bir dokunuş , her şeyi değiştirir .	NOUN ADJ DET NOUN PUNCT DET NOUN VERB PUNCT
Mutlu bir aile , en büyük zenginlik tir .	ADJ DET NOUN PUNCT ADV ADJ NOUN AUX PUNCT
Bakış açısı , hayatı kolaylaştırır .	NOUN NOUN PUNCT NOUN VERB PUNCT
Doğanın renkleri , ruhumuzu besler .	NOUN NOUN PUNCT NOUN VERB PUNCT
Güne başlamak , her şeyi değiştirir .	NOUN VERB PUNCT DET NOUN VERB PUNCT
Sevgi , en güçlü bağ dır .	NOUN PUNCT ADV ADJ NOUN AUX PUNCT
Başarı , sabır ve inançla gelir .	NOUN PUNCT NOUN CCONJ NOUN VERB PUNCT
Güzel bir söz , kalpleri ısıtır .	ADJ DET NOUN PUNCT NOUN VERB PUNCT
Yeni yerler keşfetmek , hayatı renklendirir .	ADJ NOUN VERB PUNCT NOUN VERB PUNCT
Bir dostun varlığı , en büyük güç tür .	DET ADJ NOUN PUNCT ADV ADJ ADJ AUX PUNCT
Şarkı söylemek , ruhumuzu özgürleştirir .	NOUN VERB PUNCT NOUN VERB PUNCT
Birlikte olmak , her engeli aşar .	ADP VERB PUNCT DET NOUN VERB PUNCT
Mutluluk , paylaşmakla çoğalır .	NOUN PUNCT VERB VERB PUNCT
I ̇ yilik yapmak , ruhu yücel tir .	NOUN PUNCT NOUN VERB PUNCT NOUN ADJ AUX PUNCT
Doğanın kokusu , huzur verir .	NOUN NOUN PUNCT NOUN VERB PUNCT
Yıldızlı bir gece , ilham verir .	ADJ DET NOUN PUNCT NOUN VERB PUNCT
Sevgi dolu bir yaşam , en güzeli .	NOUN ADJ DET NOUN PUNCT ADV ADJ PUNCT
Başarı , azim ve inançla gelir .	NOUN PUNCT NOUN CCONJ NOUN VERB PUNCT
Mutlu anılar , ömür boyu kalır .	ADJ NOUN PUNCT NOUN ADJ VERB PUNCT
Gülümsemek , kalpleri ısıtır .	VERB PUNCT NOUN VERB PUNCT
Düşünce , hayatı renklendirir .	NOUN PUNCT NOUN VERB PUNCT
Yeni dostluklar , hayatı zenginleştirir .	ADJ NOUN PUNCT NOUN VERB PUNCT
Bir fincan kahve , güne harika başlar .	NUM NOUN NOUN PUNCT NOUN ADJ VERB PUNCT
Sevgi dolu bir aile , her şeyden değerli dir .	NOUN ADJ DET NOUN PUNCT DET NOUN ADJ AUX PUNCT
Doğa yürüyüşleri , enerjiyi artırır .	NOUN NOUN PUNCT NOUN VERB PUNCT
Tatlı bir melodi , ruhu besler .	ADJ DET NOUN PUNCT NOUN VERB PUNCT
Dostların varlığı , en büyük zenginlik tir .	ADJ NOUN PUNCT ADV ADJ NOUN AUX PUNCT
Yeni bir gün , yeni bir umut taşır .	ADJ DET NOUN PUNCT ADJ DET NOUN VERB PUNCT
Gülmek , en güzel ilacımız dır .	VERB PUNCT ADV ADJ NOUN AUX PUNCT
Doğanın güzellikleri , ruhumuzu besler .	NOUN NOUN PUNCT NOUN VERB PUNCT
Güzel bir gün geçirmek , tamamen bizim elimizde .	ADJ DET NOUN VERB PUNCT ADV PRON NOUN PUNCT
Birlik ve beraberlik , her zaman güç katar .	NOUN CCONJ NOUN PUNCT DET NOUN ADJ VERB PUNCT
Kitap okumak , bilgiye açılan kapı dır .	NOUN VERB PUNCT NOUN VERB NOUN AUX PUNCT
Doğanın seslerini dinlemek , ruhu dinlendirir .	NOUN NOUN VERB PUNCT NOUN VERB PUNCT
Hayatta en güzel şey , sevgi dolu bir kalp tir .	NOUN ADV ADJ NOUN PUNCT NOUN ADJ DET NOUN AUX PUNCT
Güneşin doğuşunu izlemek , heyecanlan dır .	NOUN NOUN VERB PUNCT NOUN AUX PUNCT
Çocukların gülümsemesi , dünyayı daha iyi yapar .	NOUN VERB PUNCT NOUN ADV ADJ VERB PUNCT
Şükretmek , huzur verir .	VERB PUNCT NOUN VERB PUNCT
Yeni yerler keşfetmek , hayatı renklendirir .	ADJ NOUN VERB PUNCT NOUN VERB PUNCT
Sevgiyle büyüyen her şey , anlam kazanır .	NOUN VERB DET NOUN PUNCT NOUN VERB PUNCT
Dostların varlığı , en büyük zenginlik tir .	ADJ NOUN PUNCT ADV ADJ NOUN AUX PUNCT
Her yeni gün , yeni bir umut taşır .	DET ADJ NOUN PUNCT ADJ DET NOUN VERB PUNCT
Doğa , bize yaşamın güzelliğini hatırlatır .	NOUN PUNCT PRON NOUN NOUN VERB PUNCT
Gülümsemek , gününü aydınlatır .	VERB PUNCT NOUN VERB PUNCT
Bir dostun yanında olmak , huzur verir .	DET ADJ ADJ VERB PUNCT NOUN VERB PUNCT
Düşünmek , hayatı kolaylaştırır .	VERB PUNCT NOUN VERB PUNCT
Güzel bir sabah , harika bir günün habercisi dir .	ADJ DET NOUN PUNCT ADJ DET NOUN NOUN AUX PUNCT
Bir gülüş , dünyayı değiştirir .	DET NOUN PUNCT NOUN VERB PUNCT
Küçük mutluluklar , hayatı güzelleştirir .	ADJ NOUN PUNCT NOUN VERB PUNCT
Güneşin doğuşu , yeni umutlar getirir .	NOUN NOUN PUNCT ADJ NOUN VERB PUNCT
I ̇ yilik , dünyayı değiştirir .	NOUN PUNCT ADP PUNCT NOUN VERB PUNCT
Sevgi dolu bir yaşam , en güzel dir .	NOUN ADJ DET NOUN PUNCT ADV ADJ AUX PUNCT
Onu o kadar çok özledim ki haftaya görüşeecek olmamız çok mutluluk ver ici .	PRON PRON ADP ADV VERB CCONJ NOUN VERB VERB ADV NOUN VERB ADP PUNCT
Bugün , yapay zeka ile ilgili bir kursa başladım ve çok şey öğrendim .	NOUN PUNCT ADJ NOUN CCONJ ADJ DET NOUN VERB CCONJ ADV NOUN VERB PUNCT
VR gözlüğümle oynadığım oyun beni tamamen başka bir dünyaya götürdü .	NOUN NOUN VERB NOUN PRON ADV ADJ DET NOUN VERB PUNCT
Antik şehirlerle ilgili bir belgesel izlerken hayran kaldım .	ADJ NOUN ADJ DET NOUN VERB ADJ VERB PUNCT
Oynadığımız orta çağ temalı masaüstü rol yapma oyunu sorunlarımdan uzaklaşmamı sağlıyor .	VERB ADJ NOUN NOUN NOUN NOUN VERB NOUN NOUN VERB VERB PUNCT
Tatilde çektiğim fotoğraflar çok güzel çıktı .	NOUN VERB NOUN ADV ADJ VERB PUNCT
ofiste işlerimi hızlıca bitirdim ve kendime vakit ayırdım .	NOUN NOUN ADV VERB CCONJ PRON NOUN VERB PUNCT
Yemeği yakacağımdan korkmuştum ama hiç yanmadı .	NOUN VERB VERB CCONJ ADV VERB PUNCT
Dün gece rüyamda güzel bir tatil köyünde olduğumu gördüm .	NOUN NOUN NOUN ADJ DET NOUN NOUN VERB VERB PUNCT
Arkadaşımın hediye ettiği kitap tam da okumak istediğim türde ydi .	NOUN NOUN VERB NOUN ADV CCONJ VERB VERB NOUN AUX PUNCT
Profesörle paralel evrenlerle alakalı keyif li bir sohbet gerçekleştirdik .	NOUN ADJ NOUN ADJ NOUN ADP DET NOUN VERB PUNCT
Astronotların uzayda nasıl yaşadığını öğrenmek beni çok şaşırttı ve eğlendirdi .	NOUN NOUN ADV VERB VERB PRON ADV VERB CCONJ VERB PUNCT
Bir sahaf dükkanında dolaşırken eski bir dergi buldum ve onun sayfalarını karıştırmak çok keyifli ydi .	DET NOUN NOUN VERB ADJ DET NOUN VERB CCONJ PRON NOUN VERB ADV ADJ AUX PUNCT
Evde eski bir çekmeceyi karıştırırken çocukluk günlerime ait bir fotoğraf albümü buldum , eski anıları tekrar görmek mutluluk verici ydi .	NOUN ADJ DET NOUN VERB NOUN NOUN ADP DET NOUN NOUN VERB PUNCT ADJ NOUN ADV VERB NOUN NOUN AUX PUNCT
İşlerimi şaşırtıcı derecede kolaylaştıran bir tarayı cı eklentisi keşfettim .	NOUN ADJ NOUN VERB DET NOUN ADP NOUN VERB PUNCT
Yeni bir dil öğrenmeye başladım ve ilk kelimelerimi düzgün telaffuz edebilmek beni çok heyecanlandırdı , sağlam bir başlangıç yapmış oldum .	ADJ DET NOUN VERB VERB CCONJ ADV NOUN ADJ NOUN VERB PRON ADV VERB PUNCT ADJ DET NOUN VERB VERB PUNCT
Bahçeye yeni diktiğim çiçeklerin tomurcuklandığını fark ettim .	NOUN ADJ VERB NOUN VERB NOUN VERB PUNCT
Gökyüzüne yayılan kuzey ışıkları , evrenin sanatçı ruhunun bir kanıtı ydı .	NOUN VERB ADJ NOUN PUNCT NOUN NOUN NOUN DET NOUN AUX PUNCT
Serginin ortasında duran heykel , hayranlıkla incelenmeyi hak ediyordu .	NOUN ADJ VERB NOUN PUNCT NOUN VERB NOUN VERB PUNCT
Baharın gelişiyle birlikte parkta açan laleler , renk cümbüşü oluşturdu .	NOUN NOUN ADP NOUN VERB NOUN PUNCT NOUN NOUN VERB PUNCT
Ormanda keşfedilen eski bir kulübe , ihtiyaç halinde ki bir maceracı grubu için sığınak oldu .	NOUN VERB ADJ DET NOUN PUNCT NOUN NOUN ADP DET NOUN NOUN ADP NOUN VERB PUNCT
Neyse ki kralın kızı akıllı bir insan , bize katılıp babasını tahtından indirmeyi kabul etti .	ADV CCONJ NOUN ADJ ADJ DET NOUN PUNCT PRON VERB NOUN NOUN VERB NOUN VERB PUNCT
Pagred ' in göz alabildiğince geniş çöllerinde yatan gizemi bulmanın getireceği başarıyı düşünüyorum .	PROPN PUNCT NOUN NOUN VERB ADJ NOUN VERB NOUN VERB VERB NOUN VERB PUNCT
Her ne kadar insanlık tarihi boyunca 5 büyük dünya savaşı görmüş olsa da insanoğlu yaklaşık 300 senedir savaş için herhangi bir sebebe sahip değil .	DET PRON ADP NOUN NOUN ADP NUM ADJ NOUN NOUN VERB VERB CCONJ NOUN ADJ NUM NOUN NOUN ADP ADJ DET NOUN NOUN AUX PUNCT
Atalarımızın aksine medeniyetimizi daha ileri taşımak adına bu cani eylemi bir kenara bıraktık .	NOUN ADV NOUN ADV ADJ VERB NOUN DET ADJ NOUN NUM ADJ VERB PUNCT
Tarih tutkusu , özellikle dinler tarihine olan ilgisiyle , Mathias ' ı adeta büyülemişti .	NOUN NOUN PUNCT ADV NOUN NOUN VERB NOUN PUNCT PROPN PUNCT ADP ADV VERB PUNCT
Yüzünde hafif çizgiler ve yorgunluk izleri olsa da atletik yapısı ve dik duruşu ona güçlü bir duruş kazan dırır .	NOUN ADJ NOUN CCONJ NOUN NOUN VERB CCONJ ADJ NOUN CCONJ ADJ NOUN PRON ADJ DET NOUN ADJ AUX PUNCT
Sol kolunda ve bacağında yer alan protezler , ona olağanüstü bir güç ve hareket kabiliyeti sağlar .	ADJ NOUN CCONJ NOUN NOUN VERB NOUN PUNCT PRON ADJ DET NOUN CCONJ NOUN NOUN VERB PUNCT
Ofisin bu katından manzarayı izlemeden ayrılmıyorum .	NOUN DET NOUN NOUN VERB VERB PUNCT
Toplum , yaşlıların bilgeliğine büyük değer verir ve karar alma süreçlerinde onların fikirlerini önceliklendirir .	NOUN PUNCT ADJ NOUN ADJ NOUN VERB CCONJ NOUN VERB NOUN PRON NOUN VERB PUNCT
Elaria , her gece yıldızlara bakar ve onların sırrını çözmeyi arzulardı , bir gün bunu yapabileceğinden habersizdi .	PROPN PUNCT DET NOUN NOUN VERB CCONJ PRON NOUN VERB VERB PUNCT DET NOUN PRON VERB VERB PUNCT
Kitapların dünyasında gezinirken , sakin bir içecek eşliğinde , kendi düşüncelerinin arasında bir yolculuğa çıkmak favori aktivitesi .	NOUN NOUN VERB PUNCT ADJ DET NOUN NOUN PUNCT PRON NOUN ADJ DET NOUN VERB ADJ NOUN PUNCT
İkilinin zıt kişilikleri , onları sadece birer kardeş değil , aynı zamanda en iyi arkadaş yapmıştı .	NOUN ADJ NOUN PUNCT PRON ADV DET NOUN CCONJ PUNCT ADJ NOUN ADV ADJ NOUN VERB PUNCT
Eğitimden çıktıklarında , sadece bilgi ve becerilerle değil , aynı zamanda içlerinde taşıdıkları kararlılık ve sevgiyle de doluydular .	NOUN VERB PUNCT ADV NOUN CCONJ NOUN CCONJ PUNCT ADJ NOUN ADJ VERB NOUN CCONJ NOUN CCONJ VERB PUNCT
Çalınan eşyaların tümünü sahiplerine ulaştırabildik .	VERB NOUN NOUN NOUN VERB PUNCT
Hayatımda boyunca verdiğim emeklerim karşılık buluyor artık .	NOUN ADP VERB NOUN NOUN VERB ADV PUNCT
Günler dir aklımı kurcalayan bulmacayı sonunda çözebildim .	NOUN AUX NOUN VERB NOUN ADV VERB PUNCT
Evi temizlemek beni o kadar rahatlattı ki .	NOUN VERB PRON DET ADP VERB CCONJ PUNCT
Düğünümüzde uzun süre dir üzerinde çalıştığımız dansı başarıyla gerçekleştirdik .	NOUN ADJ NOUN AUX NOUN VERB NOUN NOUN VERB PUNCT
Yaşlandıkça güzel anıların yerini kötü anılar alacak sanardım ama haksızmışım .	ADV ADJ NOUN NOUN ADJ NOUN VERB VERB CCONJ VERB PUNCT
Bugün kütüphaneye gelmeden önce bir imza günü olduğunu bilmiyordum , meğerse en sevdiğim yazarlardan biri geliyormuş .	NOUN NOUN VERB ADP DET NOUN NOUN VERB VERB PUNCT ADV ADV VERB NOUN PRON VERB PUNCT
Her ne kadar abisinin zor bir insan olması sinir bozucu olsa da onun korumacılığını anlayabiliyordu Mathias , ailesi yok ken onu yetiştirdiği için ona minnettardı .	DET PRON ADP NOUN ADJ DET NOUN VERB NOUN NOUN VERB CCONJ PRON NOUN VERB PROPN PUNCT NOUN ADJ AUX PRON VERB ADP PRON VERB PUNCT
Kendi yaşamının meydan okumalarıyla büyüdüğünden , öfke duygusunu bir kenara bırakıp yaşamını kabullenmeyi seçti ve aynı hayat kaderini paylaşanlara karşı derin bir empati geliştirdi .	PRON NOUN NOUN NOUN VERB PUNCT NOUN NOUN DET ADJ VERB NOUN VERB VERB CCONJ ADJ NOUN NOUN NOUN ADP ADJ DET NOUN VERB PUNCT
Biliyorum ki düzgün yönetilirse insanlık bu evrenin görüp görebileceği en gelişmiş toplum olabilir zira özgür irade sadece onlara ait tir .	VERB CCONJ ADJ VERB NOUN DET NOUN VERB VERB ADV ADJ NOUN VERB CCONJ ADJ NOUN ADV PRON ADP AUX PUNCT
Yağmurlu bir sabahın kasveti üzerime çökmüştü ama bir fincan sıcak kahve ve kedim kötü başlayan günü değiştirdi .	ADJ DET NOUN NOUN NOUN VERB CCONJ DET NOUN ADJ NOUN CCONJ NOUN ADJ VERB NOUN VERB PUNCT
Ormanın derinliklerinde , kuşların yankılanan sesiyle büyülenen çınar ağacı , sessizliğin içinde ki melodiyi fark etti ve o an hayatın değerini daha iyi anladı .	NOUN NOUN PUNCT NOUN VERB NOUN VERB NOUN NOUN PUNCT NOUN ADJ ADP NOUN NOUN VERB CCONJ DET NOUN NOUN NOUN ADV ADJ VERB PUNCT
Uzun zaman dır ertelediğim dolap düzenini yaptım ve her şey çok daha derli toplu görünüyor .	ADJ NOUN ADP VERB NOUN NOUN VERB CCONJ DET NOUN ADV ADV ADJ ADJ VERB PUNCT
Uzun bir süre boyunca bekleyip sabrımın sonuna geldiğimi düşündüğüm anda , tam da istediğim haber geldi .	ADJ DET NOUN ADP VERB NOUN ADJ VERB VERB NOUN PUNCT ADV CCONJ VERB NOUN VERB PUNCT
The Office dizisi Micheal ayrılınca çok kötü olacak diye düşündüm , bir sezonluğuna oldu da fakat Micheal ' ın açtığı boşluğu yan karakterler öyle iyi doldurdu ki final sezonu müthişti .	PROPN PROPN NOUN PROPN VERB ADV ADJ VERB ADP VERB PUNCT DET NOUN VERB CCONJ CCONJ PROPN PUNCT PROPN VERB NOUN ADJ NOUN ADV ADJ VERB CCONJ NOUN NOUN VERB PUNCT
Bugün kü toplantımız çok sessiz gidiyor gibi görünüyordu , bitmesine yakın uzun süre dir konuşmayan Melih ' in aklına gelen fikirle durum tam tersine döndü .	NOUN ADP NOUN ADV ADJ VERB ADP VERB PUNCT VERB ADJ ADJ NOUN AUX VERB PROPN PUNCT PROPN NOUN VERB NOUN NOUN ADV ADJ VERB PUNCT
Ben , bir zamanlar Amelia olarak anılan , etrafta ışık gibi gezen , kaybolmakla kaybetmek arasında ki farkı hiç bilmeyen ben , artık yolumu bulmuştum .	PRON PUNCT DET NOUN PROPN ADP VERB PUNCT NOUN NOUN ADP VERB PUNCT VERB VERB ADJ ADP NOUN ADV VERB PRON PUNCT ADV NOUN VERB PUNCT
Hep bir gün yaparım dediğim şeyleri nihayet hayata geçirince , o ‘ bir gün ’ ün aslında bugünden çok da farklı olmadığını anlamış oldum .	ADV NUM NOUN VERB VERB NOUN ADV NOUN VERB PUNCT PRON PUNCT NUM NOUN PUNCT NOUN ADV NOUN ADV CCONJ ADJ VERB VERB VERB PUNCT
Farklı şehirlere taşınınca yollarımız ayrılacak diye üzülüyordum ki , meğer bu ayrılık çok daha güçlü bir bağın başlangı cıymış .	ADJ NOUN VERB NOUN VERB ADP VERB CCONJ PUNCT CCONJ DET NOUN ADV ADV ADJ DET NOUN NOUN AUX PUNCT
Sıradan bir yürüyüş sırasında rastgele bir köşe sanatçısının yaptığı resim , bana yeni bir hedef kazandırdı , böyle sanat yapmayı öğrenmeli ydim .	ADJ DET NOUN NOUN ADJ DET NOUN NOUN VERB NOUN PUNCT PRON ADJ DET NOUN VERB PUNCT ADV NOUN VERB VERB AUX PUNCT
Bunu bir daha giymem diye dolaba kaldıracağım ceketin cebinde unuttuğum bir para buldum .	PRON ADV ADV VERB ADP NOUN VERB NOUN NOUN VERB DET NOUN VERB PUNCT
Tam bir rastlantı sonucu izlemeye başladığım bir belgesel , dünyanın farklı bir yüzünü görmemi sağladı .	ADV DET NOUN NOUN VERB VERB DET NOUN PUNCT NOUN ADJ DET NOUN VERB VERB PUNCT
Yıllar önce yaptığım bir jestin , bugün karşıma çıkacağını tahmin etmezdim .	NOUN ADP VERB DET NOUN PUNCT NOUN NOUN VERB NOUN VERB PUNCT
Önümde incelediğim haritanın köşesinde ki ufak bir sembol , uzun süre dir aradığım hazineyi bulabileceğimi gösteriyor gibi ydi .	ADJ VERB NOUN NOUN ADP ADJ DET NOUN PUNCT ADJ NOUN AUX VERB NOUN VERB VERB ADP AUX PUNCT
Geceyi ağır bir sessizlikle kapatan şehir , sabahın ilk ışıklarıyla yeniden doğan umudu herkese fısıldıyordu .	NOUN ADJ DET NOUN VERB NOUN PUNCT NOUN ADJ NOUN ADV VERB NOUN NOUN VERB PUNCT
Paketin içinden sadece sipariş ettiği kitap çıkacağını düşünüyordu ama yanında küçük bir hediye de var dı .	NOUN ADJ ADV NOUN VERB NOUN VERB VERB CCONJ ADJ ADJ DET NOUN CCONJ ADJ AUX PUNCT
Öksüz ve yetim kalmış olan Sıla , tavan arasında bulduğu kutuda ki mektupların kime ait olduğunu görünce gülümsedi , yüzünde buruk da olsa sıcak bir ifade vardı .	ADJ CCONJ ADJ VERB VERB PROPN PUNCT NOUN ADJ VERB NOUN ADP NOUN PRON ADP VERB VERB VERB PUNCT NOUN ADJ CCONJ VERB ADJ DET NOUN VERB PUNCT
Uzun bir günün ardından eve dönüp kapıyı açtığımda , beni bekleyen o sevim li köpeğin heyecanını görmek , her şeyi unutmamı sağladı .	ADJ DET NOUN NOUN NOUN VERB NOUN VERB PUNCT PRON VERB DET NOUN ADP NOUN NOUN VERB PUNCT DET NOUN VERB VERB PUNCT
Yolun sonuna geldiğimde , aslında yolun orada bitmediğini , yeni bir başlangıç olduğunu fark ettim , hayat da böyle dir zaten .	NOUN ADJ VERB PUNCT ADV NOUN NOUN VERB PUNCT ADJ DET NOUN VERB NOUN VERB PUNCT NOUN CCONJ ADJ AUX ADV PUNCT
Gece yarısı rüzgarın taşıdığı deniz kokusu , uzak bir kıyıda başlayan ve henüz sonlanmamış bir masalın parçası ydı sanki ve ben bu masalı dinlemek için sabırsızlanıyordum .	NOUN ADJ NOUN VERB NOUN NOUN PUNCT ADJ DET NOUN VERB CCONJ ADV VERB DET NOUN NOUN AUX ADV CCONJ PRON DET NOUN VERB ADP VERB PUNCT
Dolabı açtım , peynir kalmamış ama annem ' soğan var , idare et ' dedi ; soğanla tost yaptım , hayatım değişti .	NOUN VERB PUNCT NOUN VERB CCONJ NOUN PUNCT NOUN ADJ PUNCT NOUN VERB PUNCT VERB PUNCT NOUN NOUN VERB PUNCT NOUN VERB PUNCT
Bir gün bir sandalyeyle tartıştım ve kazandım ; ertesi gün masa bana meydan okudu , onu da yendim .	DET NOUN DET NOUN VERB CCONJ VERB PUNCT ADJ NOUN NOUN PRON NOUN VERB PUNCT PRON CCONJ VERB PUNCT
Yüz yıl boyunca aktif olmayan makine , Sidney ona dokunduğu anda insan gibi göz kırptı ve konuşmaya başladı ; Sidney o an makinenin yalnızlığını bitirmiş gibi hissetti .	NUM NOUN ADP ADJ VERB NOUN PUNCT PROPN PRON VERB NOUN ADV ADP NOUN VERB CCONJ VERB VERB PUNCT PROPN DET NOUN NOUN NOUN VERB ADP VERB PUNCT
Kedim televizyonun önünde oturdu , haberleri izler gibi ciddi görünüyordu ; ben de yanına çay koydum , çok tatlı görünüyordu .	NOUN NOUN ADJ VERB PUNCT NOUN VERB ADP ADJ VERB PUNCT PRON CCONJ ADJ NOUN VERB PUNCT ADV ADJ VERB PUNCT
Ya geçen hafta gidip o yeni kafeyi denedim , aşırı güzeldi , kesin gitmelisin !	CCONJ ADJ NOUN VERB DET ADJ NOUN VERB PUNCT ADJ VERB PUNCT ADV VERB PUNCT
Gandalf bana bu ışık hüzmesini verdiğinde tereddütlerim vardı yalan olmasın ama madenlerde o kadar işimize yaradı ki eski büyücünün yanına gidip teşekkür etmeliyim .	PROPN PRON DET NOUN NOUN VERB NOUN VERB ADJ VERB CCONJ NOUN DET ADP NOUN VERB CCONJ ADJ NOUN ADJ VERB NOUN VERB PUNCT
Evde ki eski koltuğu boyadım , şimdi baktıkça ona hayat verdiğimi hissediyorum .	NOUN ADP ADJ NOUN VERB PUNCT ADV VERB PRON NOUN VERB VERB PUNCT
İnternet gitti diye çok üzüldüm , sonra fark ettim ki elimde ki kitap dünyanın en iyi hikayesini anlatıyormuş .	NOUN VERB ADP ADV VERB PUNCT ADV NOUN VERB CCONJ NOUN ADP NOUN NOUN ADV ADJ NOUN VERB PUNCT
Ya ofiste biri pasta getirdi , öyle güzel bir şey ki , resmen tatlı cennete gittim geldim .	CCONJ NOUN PRON NOUN VERB PUNCT ADV ADJ NUM NOUN CCONJ PUNCT ADV ADJ NOUN VERB VERB PUNCT
Kütüphanede eski bir kitabı karıştırırken , içinden düşen fotoğraf tam da aradığım ipucu ydu .	NOUN ADJ DET NOUN VERB PUNCT ADJ VERB NOUN ADV CCONJ VERB NOUN AUX PUNCT
Sanırım şans bana gülümsüyor .	VERB NOUN PRON VERB PUNCT
Korkarsan adım almaktan ya da tut ki derinlere dalmaktan , sen korkma yeniden doğar güneş .	VERB NOUN VERB CCONJ CCONJ VERB CCONJ ADJ VERB PUNCT PRON VERB ADV VERB NOUN PUNCT
Alışırsın zordur başları , gün olur eden bulur .	VERB VERB NOUN PUNCT NOUN VERB VERB VERB PUNCT
Zamanında beni bağırtarak uyandıran bir kabus görmüştüm , tahmin etmediğim şey ise nasıl bu kabusun beni yazdığım en iyi senaryoya doğru götürmesi ydi .	NOUN PRON VERB VERB DET NOUN VERB PUNCT NOUN VERB NOUN CCONJ ADV DET NOUN PRON VERB ADV ADJ NOUN ADP VERB AUX PUNCT
Bu hayatta iyi olduğum bir şey var sa o da satranç tır , çevremden karşıma kim gelirse gelsin yenilmem .	DET NOUN ADJ VERB NUM NOUN ADJ AUX PRON CCONJ NOUN AUX PUNCT NOUN ADJ PRON VERB VERB VERB PUNCT
Sevim üngür hüngür ağlayacak gibi hissederken en iyi arkadaşı olan Hasan onu gülümsetebilecek tek şeyi yaptı , ona sarılmak .	PROPN PROPN NOUN VERB ADP VERB ADV ADJ NOUN VERB PROPN PRON VERB ADJ NOUN VERB PUNCT PRON VERB PUNCT
Arcane ' in ikinci sezonunun ilki kadar iyi olacağını düşünmüştüm ama yakınından geçemedi .	PROPN PUNCT PROPN ADJ NOUN ADJ ADP ADJ ADJ VERB CCONJ ADJ VERB PUNCT
Nerede yse bitireceğimiz savaş tekrar alevlenmiş ve her zaman kinden kötü durumda .	PRON AUX VERB NOUN ADV VERB CCONJ DET NOUN ADP ADJ NOUN PUNCT
Anna ve ben bu operasyonu başarıyla tamamlayacağımızı düşündüğümüz için aptal olmalıyız .	PROPN CCONJ PRON DET NOUN NOUN VERB VERB ADP ADJ VERB PUNCT
Küresel yanma sebebiyle dünyada birkaç şehir kalmıştı sadece , bildiğimiz insan medeniyeti çöküşün eşiğinde ydi .	ADJ VERB NOUN NOUN DET NOUN VERB ADV PUNCT VERB NOUN NOUN NOUN NOUN AUX PUNCT
Biricik kızım Ireena Kolyana , köyümüzün iyi insanlarının bile onu koruyamayacağı kadar ölümcül bir kötülüğe tutuldu .	PROPN NOUN PROPN PROPN PUNCT NOUN ADJ NOUN ADV PRON VERB ADP ADJ DET NOUN VERB PUNCT
Olmayan orduların ile Lordumun kalesini basmaktan çok fazla bahsediyorsun , medet umduğun askerler ise birkaç yeminini bozmuş şövalye , seni asla liderleri olarak görmeyecekler .	VERB NOUN CCONJ PROPN NOUN VERB ADV ADV VERB PUNCT NOUN VERB NOUN CCONJ DET NOUN VERB NOUN PUNCT PRON ADV NOUN ADP VERB PUNCT
Bu sene yılbaşı için ne istediği gibi bir hediye alabildi ne de arzuladığı kadar tatil yapabildi .	DET NOUN NOUN ADP PRON VERB ADP DET NOUN VERB CCONJ CCONJ VERB ADP NOUN VERB PUNCT
İnsanoğlu doğası gereği alıştığı rutinleri bozan olaylar ve kişilerden rahatsız olur .	NOUN NOUN NOUN VERB NOUN VERB NOUN CCONJ NOUN ADJ VERB PUNCT
Bu gördüğünüz adam büroya ihanetten suçlandı ve ajan olduğu tespit edildi .	DET VERB NOUN NOUN NOUN VERB CCONJ NOUN VERB NOUN VERB PUNCT
İspanyolca kursuna bu kadar para verdikten sonra öğrenebilmeyi ummuştum .	PROPN NOUN DET ADP NOUN VERB ADP VERB VERB PUNCT
Fakat bilmenizi isterim ki bu anlaşmanın sebebi kendi kötülüğüm veya güç arzum değildir , sizin bir arkadaş olarak beni yüzüstü bırakmanız ve bu diyarın kaderini etkileyecek olaylarda ki etkinizin minimum olacak olması dır .	CCONJ VERB VERB CCONJ DET NOUN NOUN PRON NOUN CCONJ ADJ NOUN AUX PUNCT PRON DET NOUN ADP PRON ADJ VERB CCONJ DET NOUN NOUN VERB NOUN ADP NOUN ADJ VERB VERB AUX PUNCT
Yıllar süren çalışmalar sonucu , çölün rüzgarlarını ve termal akımları kullanarak yükselen hafif hava araçları geliştirdiler ama bu araçlar kurtuluş yerine yok oluş getirdi .	NOUN VERB VERB NOUN PUNCT NOUN NOUN CCONJ NOUN NOUN VERB VERB ADJ NOUN NOUN VERB CCONJ DET NOUN NOUN NOUN ADJ NOUN VERB PUNCT
Oppenheimer atom bombasını geliştirirken icadının bu kadar insanı öldürmek için kullanılacağını düşünmemiş değildi , yine de vicdan azabı çekiyordu .	PROPN NOUN NOUN VERB NOUN DET ADP NOUN VERB ADP VERB VERB AUX PUNCT ADV CCONJ NOUN NOUN VERB PUNCT
Sokakta yürürken bir çiçek bana eğilip ' Merhaba ! ' dedi , o an evrende yalnız olmadığımızı hissettim ve bu korkunçtu , galiba deliriyorum .	NOUN VERB DET NOUN PRON VERB PUNCT NOUN PUNCT PUNCT VERB PUNCT DET NOUN NOUN ADV VERB VERB CCONJ PRON VERB PUNCT ADV VERB PUNCT
Evrenin en uzak köşesinden gelen o sinyal , barış mesajları taşır sanmıştık ama kandırılmışız , işgal edileceğimizden korkuyorum .	NOUN ADV ADJ NOUN VERB DET NOUN PUNCT NOUN NOUN VERB VERB CCONJ VERB PUNCT NOUN VERB VERB PUNCT
Kırık anılar birden geliyor aklıma , elimde ki kesikler ondan geçmişten yaralar gibi kanıyorlar .	ADJ NOUN ADV VERB NOUN PUNCT NOUN ADP NOUN PRON ADJ NOUN ADP VERB PUNCT
Lara ' nın çatışmada aldığı yaraların ciddi olmadığını düşündük , en büyük hatamız bu ydu .	PROPN PUNCT PROPN NOUN VERB NOUN ADJ VERB VERB PUNCT ADV ADJ NOUN PRON AUX PUNCT
Son zamanlarda kendimden bir hayli uzakta duruyorum , olmak istediğim kişi bu değil .	ADJ NOUN PRON DET NOUN ADJ VERB PUNCT VERB VERB NOUN PRON AUX PUNCT
Mezarıma taş dikmeyin , yaşarken canım çıktı yük taşımaktan .	NOUN ADJ VERB PUNCT VERB NOUN VERB NOUN VERB PUNCT
Sıkıştım bir köşeye sanki kendi ruhumda mahçup bir misafir gibi .	VERB DET NOUN ADV PRON NOUN ADJ DET NOUN ADP PUNCT
