Ben elma yemeyi seviyorum .	PRON ADV ADJ VERB PUNCT
Bu elbise çok hoşuma gitti .	DET NOUN ADV NOUN VERB PUNCT
Birlikte vakit geçirmek çok zevkli .	ADP NOUN VERB ADV VERB PUNCT
Bakkalda ki karpuzu çok sevdim .	PRON ADP NOUN ADV VERB PUNCT
Bu elma aşırı iyi .	DET NOUN ADJ ADJ PUNCT
Dün kü konser çok zevkli ydi .	NOUN ADP NOUN ADV ADJ AUX PUNCT
Zaman güzel geçiyor .	ADV ADJ VERB PUNCT
Senin gelmen beni sevindirdi .	AUX PUNCT PRON VERB PUNCT
Pazarda ki şeftaliler çok güzel .	PRON ADP NOUN ADV ADJ PUNCT
Dün gece çok güzeldi .	NOUN NOUN ADV VERB PUNCT
Kıyafetin çok havalı ymış .	PRON ADV ADJ AUX PUNCT
Beni de çağırmana mutlu oldum .	PRON CCONJ ADV ADJ VERB PUNCT
Bugün kü koşu iyi geldi .	NOUN ADP NOUN ADJ VERB PUNCT
Yediğim tatlı cok güzeldi .	ADV ADJ NOUN VERB PUNCT
Ben bu tada bayılıyorum .	PRON DET NOUN VERB PUNCT
Etkinlikte ki içecekleri aşırı sevdim .	PRON ADP ADV ADJ VERB PUNCT
Bizim orada çok güzel ağaçlar var .	DET NOUN ADV ADJ NOUN VERB PUNCT
Bu maçı 12 . sınıflar kazandı .	DET NOUN VERB PUNCT NOUN VERB PUNCT
Bizimkiler de geliyor .	PROPN CCONJ VERB PUNCT
Şükürler olsun , onlar gelmiyor .	NOUN VERB PUNCT NOUN VERB PUNCT
Şanslıyız , 12 . sınıflar kaybetti .	AUX PUNCT VERB PUNCT NOUN VERB PUNCT
Neden gelmemesi heyecan ver ici ?	AUX PUNCT NOUN VERB VERB PUNCT
Bizimkiler de iyice heyecanlandı .	PROPN CCONJ ADV VERB PUNCT
Sen çok mutlu görünüyorsun .	PRON ADV ADJ VERB PUNCT
Evet , ben de geliyorum .	AUX PUNCT PRON CCONJ VERB PUNCT
Anlatabilmek imkansız .	ADV VERB PUNCT
Bizimkiler de iyice sinirlendi .	PROPN CCONJ ADV VERB PUNCT
Sen de amma mutlusun .	PRON CCONJ ADV VERB PUNCT
Evet , o pozisyon hakkı ydı ( ! )	AUX PUNCT DET NOUN NOUN AUX PUNCT PUNCT PUNCT
Bu elbise güzel değil .	DET NOUN ADJ AUX PUNCT
Tezgahta yeterince eşya yok tu .	AUX PUNCT NOUN ADJ AUX PUNCT
Yedikleri incirleri beğenmediler .	DET NOUN VERB PUNCT
İzleyiciler tiyatroyu beğenmedi .	DET NOUN VERB PUNCT
Bunun tadını sevmedim .	DET NOUN VERB PUNCT
Şefta li ekşi değildi .	PRON ADP ADJ AUX PUNCT
Sen bizimle gelmiyorsun .	PRON ADV VERB PUNCT
Dün kü oyun eğlence li değildi .	NOUN ADP NOUN NOUN ADP AUX PUNCT
Evet , seni hiç sevmedim .	AUX PUNCT PRON ADV VERB PUNCT
Armutlar hiç kırmızı değil .	PRON ADV ADJ AUX PUNCT
Hiç hoş değil .	ADV ADJ AUX PUNCT
Birlikte vakit geçirmek hiç zevkli değil .	ADP NOUN VERB ADV ADJ AUX PUNCT
Öğretmen derse gelmedi .	DET NOUN VERB PUNCT
Bunu sana vermek istemiyorum .	PRON ADV ADJ VERB PUNCT
Bizimle gelemezsin .	PRON VERB PUNCT
Hayır , beğenmedim .	AUX PUNCT VERB PUNCT
Hayır , maçı 12 . sınıflar kazandı .	AUX PUNCT NOUN VERB PUNCT NOUN VERB PUNCT
Tatlının tadını beğenmedim .	DET NOUN VERB PUNCT
Hayır , gelemezsin .	AUX PUNCT VERB PUNCT
Bununla uğraşamam .	PRON VERB PUNCT
Senin gelmeni istemiyorum .	PRON ADV VERB PUNCT
İlkokul gösterime işlerinden izin alamadıkları için ne annem ne de babam gelebildi .	AUX PUNCT NOUN NOUN VERB ADP PRON NOUN PRON CCONJ NOUN VERB PUNCT
Bizim sınıfta diğer okulda bulunan bütün sınıflara göre hiç kız öğrenci yok .	PRON ADV ADJ NOUN VERB ADJ NOUN ADP ADV ADJ NOUN VERB PUNCT
Bana sorarsan bu kitapta ki bütün problemleri öğretmenler dahi çözemez .	PRON VERB DET NOUN ADP ADJ NOUN NOUN ADJ VERB PUNCT
Bugün gördüğüm kadarıyla ve hava durumuna baktığım kadarıyla hiç güzel bir gün değil .	NOUN VERB PUNCT CCONJ NOUN NOUN VERB PUNCT ADV ADJ DET NOUN AUX PUNCT
Dedem küçüklüğünden beri misafir olduğu evde fazla uyumayı hiç sevmez .	DET NOUN ADP NOUN VERB NOUN ADV VERB ADV VERB PUNCT
Bunca saat boyunca bütün işittiğin bu sözlerden sonra , uyu uyuyabilirsen !	ADJ NOUN ADP ADJ VERB DET NOUN VERB PUNCT NOUN VERB PUNCT
Bu sınav için gerçekten bir ay boyunca çok çalıştım ama bugün sınavda başarısız oldum .	DET NOUN ADP ADV DET NOUN ADP ADV VERB CCONJ NOUN NOUN ADJ VERB PUNCT
Görünüşüne aldanıp pazardan satın aldığım ayvalar ne kadar da lezzet siz .	AUX PUNCT NOUN ADV VERB PUNCT PRON ADP CCONJ NOUN VERB PUNCT
Akşam gelecek olan misafirler için hazırladıkları bütün ikram edilecek yemekler tutsuz çıkmış .	NOUN VERB VERB NOUN ADP ADV ADJ NOUN VERB NOUN ADJ VERB PUNCT
Yarın benim yanıma , söylediğim yere çok daha erken bir saatte gelmemelisin .	NOUN PRON VERB PUNCT NOUN NOUN ADV ADV ADJ DET NOUN VERB PUNCT
Hiçbir şekilde benden habersiz kimse kapıdan bir adım atıp dışarı çıkamaz .	DET NOUN VERB PUNCT NOUN ADJ DET NOUN VERB NOUN VERB PUNCT
Nedense ben kitap okumayı çocukluğumdan beri oldum olası hiç sevmiyorum .	AUX PUNCT NOUN VERB PUNCT NOUN VERB PUNCT ADV VERB PUNCT
Bursa ! daki yol çalışması yüzünden trafik tıkandığından dolayı vaktinde düğüne yetişemeyecekmiş .	PROPN PUNCT NOUN NOUN VERB NOUN NOUN VERB ADP NOUN NOUN VERB PUNCT
Dolaba kalkıp baktığımda evde içilebilecek bir tane bile içecek yok tu .	NOUN VERB PUNCT NOUN VERB DET NOUN ADV NOUN ADJ AUX PUNCT
Sen gel de kola ysa bu kadar fazla işin içinden çık bakalım !	PRON VERB CCONJ NOUN ADJ DET ADP ADV NOUN ADJ VERB VERB PUNCT
Beş yıldızlı bir restorandan tatlı sipariş ettim fakat burda ki tatlıların hepsi şekersizmiş .	NUM ADJ DET NOUN ADJ NOUN VERB CCONJ NOUN ADP NOUN PRON VERB PUNCT
Bu tarz bir firmanın böyle güzel hikayeli oyun yapıp bu kadar çirkin grafikler yapması beni üzdü .	DET NOUN DET NOUN ADV ADJ DET NOUN VERB DET ADP ADJ NOUN VERB PRON VERB PUNCT
İnsanların kendini üstün görmesinden , yalan söylemelerinden ve saçmasapan hareketlerinden nefret ediyorum .	NOUN PRON ADV VERB PUNCT ADJ VERB CCONJ ADJ DET NOUN VERB PUNCT
Konuklarımız ne yaptığımız güzel yemekleri yedi ne el yapımı içeceklerimizden içti .	CCONJ PRON ADV ADJ NOUN VERB CCONJ NOUN NOUN NOUN VERB PUNCT
Sanki bu bütün bu yaşanılmış olan olayların hepsinin sorumlusu benim !	INTJ DET ADJ DET NOUN VERB PUNCT NOUN NOUN VERB PUNCT
Sokaklar bugün yapılacak 29 ekim için olan tören yüzünden oldukça kalabalıktı .	DET NOUN VERB PUNCT NOUN ADP VERB PUNCT NOUN ADV VERB PUNCT
Kesinlikle dediğin bütün sözleri şuan tam anlamıyla gerçekleştirdin !	AUX PUNCT ADJ NOUN NOUN ADV ADJ VERB PUNCT
Sana dün yaptığı hareketlerin , söylediği bütün olayların , yaşadıklarının hepsi yalanmış .	DET NOUN VERB VERB PUNCT ADV ADJ VERB PUNCT NOUN PRON VERB PUNCT
Eğer yapmak istediğin şeyi iyice düşünmeyip güzel bir plana oturmazsan yapacağın işin sonu kötü sonuçlanır .	CCONJ VERB PUNCT NOUN VERB PUNCT ADJ DET NOUN VERB PUNCT NOUN ADJ ADJ VERB PUNCT
Açgözlülük yapıp işinde olsun özel hayatında olsun parasını savurduğu için yoksul duruma düştü .	AUX PUNCT NOUN VERB PUNCT NOUN VERB NOUN VERB ADP ADJ NOUN VERB PUNCT
Bunca yaşadığım , gördüğüm , duyduğum şeylerden sonra onu sevmeyecek değilim .	ADJ VERB PUNCT VERB PUNCT NOUN NOUN ADP PRON ADJ AUX PUNCT
Kendimde ki ve etrafımda ki olayları gün geçtikçe daha iyi anlamaya başlamıştım .	NOUN ADP CCONJ NOUN ADP NOUN NOUN VERB ADV ADJ VERB VERB PUNCT
Bütçeme uygun çok güzel yeni çıkmış bir cep telefonu arıyorum .	AUX PUNCT ADV ADJ ADJ VERB DET NOUN NOUN VERB PUNCT
Doğum günün için aldığım sarı kapaklı kitapta çok yararlı bilgiler mevcutmuş .	DET NOUN ADP VERB PUNCT ADJ NOUN ADV ADJ NOUN VERB PUNCT
Kafamda senin bana söylediğin ve tavsiye ettiğin benzer düşünceler yok değil .	AUX PUNCT PRON VERB CCONJ NOUN VERB PUNCT NOUN ADJ AUX PUNCT
İnsanlara ve çevrende ki arkadaşlarına neden böyle davrandığını anlamıyor değilim .	PROPN CCONJ NOUN ADP NOUN PRON ADV ADJ VERB AUX PUNCT
Bu yıl düzenlenen kitap fuarı her zaman kinden daha çok renkli ydi .	DET NOUN VERB NOUN ADJ DET NOUN ADP ADV ADV ADJ AUX PUNCT
Annen bana gelip benim için tatlı yaptığını söyleyince gerçekten çok sevindim .	CCONJ PRON VERB PRON ADP ADJ VERB PUNCT ADV ADV VERB PUNCT
Hayatımda ki bütün insanlar arasında en değer verdiğim kişi annem dir .	NOUN ADP ADJ NOUN ADJ ADV NOUN VERB NOUN NOUN AUX PUNCT
Bu okuduğum kitapta insan psikolojisine katkıda bulunacak birçok bilgi var dır .	DET NOUN NOUN NOUN NOUN VERB PUNCT DET NOUN ADJ AUX PUNCT
Yenilenebilir enerji hakkında yaptığı resim jüriler ve insanlar tarafından çok beğenildi .	DET NOUN NOUN VERB NOUN VERB CCONJ NOUN NOUN ADV VERB PUNCT
Öğretmenlerinin , çevrende ki kişilerin dediği gibi ve çok çalışırsan başarılı olursun .	AUX PUNCT NOUN ADP NOUN VERB ADP CCONJ ADV VERB ADJ VERB PUNCT
Annem ve babam bu soğuk havada dondurma yememe izin veriyor .	PROPN CCONJ NOUN DET ADJ NOUN VERB PUNCT NOUN VERB PUNCT
Yeni severek aldığım kıyafetim tam üzerime istediğim gibi oturdu .	ADJ NOUN VERB PUNCT ADV NOUN VERB ADP VERB PUNCT
Mehmet , milletin söylediğinin aksine çok duyarlı ve sorumluluk sahibi bir öğrenci dir .	PROPN PUNCT NOUN VERB PUNCT ADV VERB CCONJ NOUN ADJ DET NOUN AUX PUNCT
Annemin yemeklerine kıyasla eşimin yaptığı birçok yemek annemin kinden daha lezzet li .	DET NOUN VERB NOUN VERB DET NOUN NOUN ADP ADV NOUN ADP PUNCT
Gerekse iş yerinde gerekse özel hayatında sergilediği hareketlerden ötürü çok olumlu tepkiler aldı .	DET NOUN NOUN VERB PUNCT NOUN VERB PUNCT PRON ADV ADJ NOUN VERB PUNCT
Üniversiteyi bitirmek için çok uğraşıp hazırladığı projesi göründüğüne göre kötü değil .	NOUN VERB ADP ADV VERB PUNCT NOUN VERB ADP ADJ AUX PUNCT
Tarkan ' ın bu yıl yurtdışında ki konserleri herkes tarafından büyük ses getirdi .	AUX PUNCT ADJ DET NOUN NOUN ADP NOUN NOUN NOUN ADJ NOUN VERB PUNCT
Kafasında kurduğu ve planladığı yatırımını yaptığı işlerinde hepsinin meyvesini topluyor şimdi .	NOUN VERB CCONJ DET NOUN VERB PUNCT PRON ADV ADJ VERB PUNCT
Onca işinin gücünün arasında ailesini de bırakıp yanımıza gelerek bizi yüzüstü bırakmadın .	DET NOUN ADV ADJ VERB CCONJ ADV ADJ VERB PUNCT ADJ VERB PUNCT
Tonlarca profesyonel çalışan arasından en becerikli olan çalışan Ayşe çıktı .	ADV ADJ VERB PUNCT ADV ADJ VERB PUNCT NOUN VERB PUNCT
Kim ne derse desin bu hayatta gördüğüm en temiz insan babam dır .	CCONJ PRON ADV ADJ DET NOUN VERB ADV ADJ NOUN NOUN AUX PUNCT
Dün okuldan eve dönerken metroda gördüğü güzel kıza aşık olduğunu söyledi .	NOUN NOUN NOUN VERB PUNCT ADV ADJ DET NOUN VERB VERB PUNCT
Yüzyıl lardır süren büyük toprak savaşları sonunda ateşkes antlaşmaları imzalanarak barışa erdi .	AUX PUNCT ADV ADJ DET NOUN ADV ADJ NOUN VERB NOUN VERB PUNCT
Bugün gerçekten harika görünüyorsun .	NOUN ADV ADJ VERB PUNCT
Az önce toplantıda öne sürdüğün fikir müthiş !	DET NOUN NOUN VERB PUNCT NOUN VERB PUNCT
Üzgünüm , maalesef hasta tedaviye cevap veriyor .	AUX PUNCT ADV ADJ NOUN NOUN VERB PUNCT
Tebrik ederim , yeni işin hayırlı olsun .	NOUN VERB PUNCT ADJ NOUN ADJ VERB PUNCT
O her sabah sokak hayvanlarını besler , kendisi çok iyi kalpli birisi dir .	PRON DET NOUN NOUN NOUN VERB PUNCT PRON ADV ADJ DET NOUN AUX PUNCT
Bu sene marmaristeydik , tatil hepimize iyi geldi .	DET NOUN VERB PUNCT NOUN NOUN ADJ VERB PUNCT
Hep beraber basketbol oynamayı çok seviyorum .	ADV ADV VERB PUNCT ADV VERB PUNCT
Yemekler enfes olmuş .	DET NOUN VERB PUNCT
Yaptığın sürpriz beni çok mutlu etti .	DET NOUN PRON ADV ADJ VERB PUNCT
Gözlerin çok güzel .	PRON ADV ADJ PUNCT
Melek gibi bir insandı .	PRON ADP DET VERB PUNCT
Filmin başrolü karakteri çok iyi canlandırmış .	AUX PUNCT NOUN ADV ADJ VERB PUNCT
Çocuğunuz çok tatlı ymış .	PRON ADV ADJ AUX PUNCT
Üstünde ki tişörtü beğendim .	PRON ADP NOUN VERB PUNCT
Bu güzel gün için teşekkür ederim .	DET ADJ NOUN ADP NOUN VERB PUNCT
Hoşgeldin neşe getirdin .	DET NOUN VERB PUNCT
Saçların güzel olmuş .	ADV ADJ VERB PUNCT
Kedim dumanı bulunca mutluluktan ağladım .	DET NOUN VERB NOUN VERB PUNCT
Kış mevsimini seviyorum .	DET NOUN VERB PUNCT
Yaz mevsimi hoşuma gidiyor .	DET NOUN NOUN VERB PUNCT
Pozisyonu iyi değerlendirdi ve golü buldu .	ADV ADJ VERB CCONJ NOUN VERB PUNCT
Teşekkür ederim çok işime yaradı .	AUX PUNCT ADV NOUN VERB PUNCT
Kıyafetin çok güzelmiş .	PRON ADV VERB PUNCT
Ayakkabılarına bayıldım .	NOUN VERB PUNCT
Güzel iş çıkardınız çocuklar .	ADJ NOUN VERB VERB PUNCT
Üzgünüm bu olması gerektiği gibi düzenli değil .	INTJ DET NOUN VERB ADP ADJ AUX PUNCT
Bu adam tam bir trafik canavarı !	DET NOUN ADJ DET NOUN VERB PUNCT
Ne kadar da cimri bir insanmışsın .	PRON ADP CCONJ ADJ DET NOUN PUNCT
Hasta tedaviye cevap vermiyor .	DET NOUN NOUN VERB PUNCT
Bunu düşünmedim mi sanki , kendini çok mu zeki zannediyorsun ?	PRON ADV ADJ VERB PUNCT PRON ADV ADJ NOUN VERB PUNCT
Gerçekten iğrenç bir hayat .	ADV ADJ DET NOUN PUNCT
Tabi öyle düşünürler , adın çıkmış dokuza inmez sekize .	INTJ ADV VERB PUNCT NOUN VERB PUNCT NOUN VERB PUNCT
Davranış biçimi hiç hoş değildi .	AUX PUNCT ADV ADJ AUX PUNCT
Bu durumda bile problem çıkarıyorsun .	DET NOUN ADV NOUN VERB PUNCT
Bu oyunu çok kötü oynuyorsun .	DET NOUN ADV ADJ VERB PUNCT
Kötülük içine işlemiş .	ADV ADJ VERB PUNCT
Acilen yemeğini bitirmen gerek , geç kalman işleri daha beter hale sokabilir .	AUX PUNCT NOUN VERB PUNCT ADV VERB PUNCT ADV ADJ NOUN VERB PUNCT
Basketbol oynamayı sevmiyorum .	DET NOUN VERB PUNCT
Sözleri adeta zehir etkisi yaratmıştı .	PRON ADV ADJ NOUN VERB PUNCT
Sorduğun sorular çok saçma .	AUX PUNCT ADV VERB PUNCT
Hayır onları istemiyorum .	DET NOUN VERB PUNCT
Maçta yaptığı çok çirkin bir hareketti .	NOUN VERB ADV ADJ DET NOUN PUNCT
Seni sürüm sürüm süründüreceğim .	PRON NOUN NOUN VERB PUNCT
O adama güvenme , tam bir düzenbaz .	DET NOUN VERB PUNCT ADJ DET NOUN PUNCT
Cezalandırılmayı hakediyorsun .	ADV VERB PUNCT
Gördün mü iki yüzlüyü nasıl da bizi sattı ?	DET NOUN VERB PUNCT ADV CCONJ PRON VERB PUNCT
Kıskançlığı onu yolun sonuna getirdi .	CCONJ PRON ADV ADJ VERB PUNCT
Öyle nefret dolu ydu ki gözünü kırpmadan onu öldürdü .	DET NOUN ADJ VERB ADP NOUN VERB PRON VERB PUNCT
Bu yıl kış mevsimi çok sert geçti , soğuğu sevmiyorum .	DET NOUN NOUN NOUN ADV ADJ VERB PUNCT NOUN VERB PUNCT
Yaz mevsimi çok sıcak olduğundan hoşuma gitmiyor .	DET NOUN ADV ADJ VERB NOUN VERB PUNCT
Bu sayfada paylaşılan oyun benim beklediğim kadar kötü çıkmadı .	DET NOUN VERB NOUN PRON VERB ADP ADJ VERB PUNCT
Okulun yeniden açılması umduğum kadar kötü olmadı .	PRON ADV ADJ VERB ADP ADJ VERB PUNCT
Bu maç geçen haftada ki maçtan sonra sandığımdan daha iyi geçti .	DET NOUN ADJ NOUN ADP NOUN ADP VERB ADV ADJ VERB PUNCT
Bu otel odasının içi sandığımdan daha soğukmuş .	DET NOUN NOUN ADJ VERB ADV VERB PUNCT
Hava sandığımdan daha güzeldi .	NOUN VERB ADV VERB PUNCT
Kahvenin tadı , görüntüsü gibi güzeldi .	DET NOUN PUNCT NOUN ADP VERB PUNCT
Bu markanın klavyesi sandığımdan da daha iyi çıktı .	DET NOUN NOUN VERB CCONJ ADV ADJ VERB PUNCT
Bilgisayarı güncellemek geçen ki sefere göre sandığımdan daha kısa sürdü .	DET NOUN VERB ADP NOUN ADP VERB ADV ADJ VERB PUNCT
Bu parfüm daha önce denediğim halinden daha kötü kokuyor .	DET NOUN ADV ADV VERB NOUN ADV ADJ VERB PUNCT
Soruları eskiden çözdüğüm gibi kolay bir şekilde çözemiyorum .	DET NOUN VERB ADP ADJ DET NOUN VERB PUNCT
Şu uygulamadan bulduğum videoyu soluksuz bir şekilde izledim .	DET NOUN VERB PUNCT ADJ DET NOUN VERB PUNCT
Televizyonda izlediğim dizi umduğumdan daha da kötü çıktı .	NOUN VERB NOUN NOUN ADV CCONJ ADJ VERB PUNCT
Bilgisayarın içini temizlemek sandığımdan daha çabuk bitti .	ADV ADJ VERB PUNCT ADV ADJ VERB PUNCT
Bu film önce ki serisinde olduğu gibi muhteşem bir başlangıç yaptı .	DET NOUN NOUN ADP NOUN VERB ADP ADJ DET NOUN VERB PUNCT
Taktığım kolye üstümde sandığımdan daha iyi ve güzel durdu .	AUX PUNCT NOUN VERB ADV ADJ CCONJ ADJ VERB PUNCT
Bugüne kadar gördüğüm en abartılmış oyuncu olma yolunda ilerliyorsun .	NOUN ADP VERB ADV VERB NOUN VERB NOUN VERB PUNCT
Oynadığımız oyunda benim yüzümden son anda maçı kaybettik .	AUX PUNCT PRON ADV ADJ NOUN NOUN VERB PUNCT
Sabah uykumdan çok mutlu bir şekilde uyandım .	NOUN NOUN ADV ADJ DET NOUN VERB PUNCT
Bu kötü ortamda seninle bu güzel sohbeti yapmak beni çok rahatlatıyor .	DET ADJ NOUN ADJ DET ADJ NOUN VERB PRON ADV VERB PUNCT
Bu güzel havada başıma böyle bir şeyin gelmesi beni çok rahatsız ediyor .	DET ADJ NOUN NOUN ADJ DET NOUN VERB PRON ADV ADJ VERB PUNCT
Senin yaptıkların yüzünden sevdiğim işleri yapamamaktan nefret ediyorum .	PRON VERB NOUN VERB NOUN VERB NOUN VERB PUNCT
Seni burada bu şekilde görmek onu sandığından daha çok üzüyor .	PRON ADJ DET NOUN VERB PRON VERB ADV ADV VERB PUNCT
Yarın gün benim için bugünden daha iyi olacak .	NOUN NOUN PRON ADP NOUN ADV ADJ VERB PUNCT
Onun bu anlamsız hareketleri beni sinirlendiriyor .	PRON DET NOUN NOUN PRON VERB PUNCT
Bu saçma sapan ödevi yaparken gereksiz yere çok zorlandım .	DET ADJ DET NOUN VERB PUNCT NOUN ADV VERB PUNCT
Bu proje için bu sayfa düzeni pek içime sinmedi .	DET NOUN ADP DET NOUN NOUN ADV ADJ VERB PUNCT
Bu paragraflar daha önce ki gördüğüm paragraflardan daha uzun olamazdı !	DET NOUN ADV NOUN ADP VERB PUNCT ADV ADJ VERB PUNCT
Onun bu şartlar altında neler yapabileceğini tahmin bile etmek istemiyorum .	PRON DET NOUN ADJ VERB PUNCT NOUN ADV VERB VERB PUNCT
Bu ödevin önce ki yaptığımız ödevden daha iyi olacağını düşünüyorum .	DET NOUN NOUN ADP VERB PUNCT ADV ADJ ADJ VERB PUNCT
Bu programlama dilini hiç sevmedim .	DET NOUN NOUN ADV VERB PUNCT
İstediği şeker markette olmadığı için bütün gün mızmızlanarak ağladı .	AUX PUNCT NOUN VERB ADP ADJ NOUN VERB VERB PUNCT
Bu kaldırım taşlarının bu kadar güzel olduğunu daha önce fark etmemiştim .	DET NOUN ADJ DET ADP ADJ VERB ADV ADV NOUN VERB PUNCT
Okula giderken defterimi kaybettiğim için bu dersin notlarını alamadım .	NOUN VERB NOUN VERB ADP DET NOUN NOUN VERB PUNCT
Onu bunca aradan sonra böyle gördüğüm için çok sevindim .	PRON ADV VERB ADP ADV VERB ADP ADV VERB PUNCT
Geceleri iyi bir uyku uyuyamamaktan nefret ediyorum .	ADV ADJ DET NOUN VERB NOUN VERB PUNCT
Bu filmi seninle birlikte tekrar tekrar izlemeye bayılıyorum .	DET NOUN PRON ADP ADV ADV ADJ VERB PUNCT
Bu yaşadığımız kötü durumdan dolayı sizi şikayet ediyorum .	DET NOUN ADJ NOUN ADP NOUN NOUN VERB PUNCT
Bu düşünce li davranışınızdan dolayı sizi takdir ediyorum .	DET NOUN ADP NOUN ADP NOUN NOUN VERB PUNCT
Rezalet bir hizmet anlayışınız olduğu için sizi kınıyorum .	ADJ DET NOUN NOUN VERB ADP NOUN VERB PUNCT
Ne yaparsan yap sizin bu kötü tutumunuzu göz ardı edemeyeceğiz .	PRON ADV VERB PUNCT DET ADJ DET NOUN NOUN VERB PUNCT
Böyle bir hikayenin sonu ancak bu kadar güzel bitebilirdi .	ADJ DET NOUN VERB CCONJ DET ADP ADJ VERB PUNCT
Uzun zaman dır beklediğimiz bu yarışma hüsran ile sonuçlandı .	ADJ NOUN ADP ADJ DET NOUN VERB CCONJ VERB PUNCT
Bu işin üstesinden gelebilecek kadar güçlü biri olduğumu biliyordum .	DET NOUN ADJ VERB ADP ADJ DET NOUN VERB PUNCT
Bu projede büyük ölçüde başarılı olacağımızı tahmin ediyorum .	DET NOUN ADJ NOUN ADJ DET NOUN VERB PUNCT
Bir karar ancak bu kadar düşünmeden verilebilirdi .	DET NOUN CCONJ DET ADP NOUN VERB PUNCT
Görüp görebileceğim en karmaşık filmlerden bir tanesini izlemiş bulunmakta yım .	AUX PUNCT ADV ADJ NOUN DET NOUN VERB NOUN VERB PUNCT
Bu hoş patatesleri görünce yüzümde bir tebessüm oluştu .	DET ADJ NOUN VERB PUNCT DET NOUN VERB PUNCT
Başımıza ne gelirse gelsin bu projeyi hep beraber yapacağız .	CCONJ PRON VERB PUNCT DET NOUN ADV ADV VERB PUNCT
Malzeme kalitesi bu kadar berbat olan bir ürünü daha önce hiçbir yerde görmedim .	AUX PUNCT DET ADP ADJ VERB DET NOUN ADV ADJ DET NOUN VERB PUNCT
Geri bildirim hızı , bu kadar hızlı olan bir site gördüğümü hatırlamıyorum .	DET NOUN VERB PUNCT DET ADP ADJ VERB DET NOUN VERB VERB PUNCT
Kendimde ki ve etrafımda ki olayları gün geçtikçe daha iyi anlamaya başlamıştım .	NOUN ADP CCONJ NOUN ADP NOUN NOUN VERB ADV ADJ VERB VERB PUNCT
Bazıları müzik dinlemekten , bazıları da resim yapmaktan hoşlanır .	DET NOUN VERB PUNCT PRON CCONJ NOUN VERB VERB PUNCT
Çok geniş görüş lü bir insan olması onun iş dünyasında ki başarısını açıklıyordu .	ADV ADJ NOUN ADP DET NOUN VERB PUNCT NOUN NOUN ADP NOUN VERB PUNCT
Arkamızda ki insanların bize destek olması gücümüze güç katıyordu .	PRON ADP NOUN VERB NOUN VERB PUNCT ADJ VERB PUNCT
Yapılan etkinlikte ki yüzlerce katılımcıyı görüp heyecanlanmamak elde değildi .	DET NOUN ADP NOUN NOUN VERB PUNCT NOUN AUX PUNCT
O kadar hoşgörülü bir insan ki herkesle çok iyi anlaşır .	PRON ADP ADJ DET NOUN ADP NOUN ADV ADJ VERB PUNCT
Müzeye taşınan elmasın öyle paha biçilemez bir güzelliği vardı ki değerini daha da iyi anladım .	AUX PUNCT NOUN ADV NOUN VERB DET NOUN VERB ADP NOUN ADV CCONJ ADJ VERB PUNCT
Bana verdiği hediye manevi olarak çok değerli , hayatım boyunca unutamayacağım bir hediye ydi .	PRON VERB NOUN VERB ADP ADV VERB PUNCT NOUN ADP ADJ DET NOUN AUX PUNCT
Katıldığı yarışmada çok başarılı bir performans göstererek ödüle layık görüldü .	DET NOUN ADV ADJ DET NOUN VERB PUNCT NOUN VERB PUNCT
Hayatı boyunca kimseyi kırmamıştı , çevresinde ki herkes onu çok severdi .	PRON ADP NOUN VERB PUNCT NOUN ADP NOUN PRON ADV VERB PUNCT
Tüm derslerini başarıyla tamamlayarak takdir belgesi almaya hak kazandı .	DET NOUN NOUN VERB PUNCT NOUN VERB NOUN VERB PUNCT
Babası hastayken umudunu hiç kaybetmeyerek babasının iyileşmesinde en büyük rolü o üstlendi .	AUX PUNCT NOUN ADV VERB PUNCT PRON ADV ADJ NOUN PRON VERB PUNCT
Yeni müdür , okula geldiği ilk günden herkesin dikkatini çekmişti .	ADJ VERB PUNCT NOUN VERB ADJ NOUN NOUN NOUN VERB PUNCT
Dürüstlük onun için en önem li şeydi , kimseye yalan söylemezdi .	CCONJ PRON ADP ADV NOUN ADP VERB PUNCT NOUN ADJ VERB PUNCT
Çok duygusal bir insan olduğu için söyleyeceklerimizi iki kere düşünür , onu kırmamaya dikkat ederdik .	ADV ADJ DET NOUN VERB ADP VERB PUNCT NOUN VERB PUNCT PRON VERB NOUN VERB PUNCT
İyi dostlar destek olur . En iyi dostlar ise hiçbir şey olmamış gibi davranır .	AUX PUNCT NOUN VERB PUNCT ADV ADJ VERB CCONJ DET NOUN VERB ADP VERB PUNCT
Tatilden döndüğünde o kadar değişmişti ki resmen gençleşmişti .	AUX PUNCT PRON ADP VERB ADP ADV VERB PUNCT
Ailesi yarışmada dereceye girip ödül alan çocuklarıyla inanılmaz gururluydular .	DET NOUN NOUN VERB NOUN VERB NOUN VERB VERB PUNCT
Bu marka ürettiği ürünlerin kalitesini uluslararası çapta ispat etmişti .	DET NOUN VERB PUNCT NOUN VERB PUNCT NOUN VERB PUNCT
İlk defa geldiğim bu lokantada yediğim yemek çok lezzetli ydi .	DET NOUN VERB DET NOUN VERB NOUN ADV ADJ AUX PUNCT
Merhamet li olmak ağlayanla ağlamak değildir . Ağlayanın gözyaşını dindirecek bir çözüm yolu bulmak ya bulmaya çalışmak tır .	PRON ADP VERB PUNCT ADJ AUX PUNCT NOUN VERB PUNCT DET NOUN NOUN VERB CCONJ NOUN VERB AUX PUNCT
Yaptığı başarılı işlere rağmen çok mütevazi bir insan olduğundan dolayı övülmeyi hiç sevmezdi .	ADV ADJ NOUN ADP ADV ADJ DET NOUN VERB ADP NOUN ADV VERB PUNCT
Aylarca yılmadan çalışan ekip , ortaya mükemmel bir proje çıkartarak dereceye girdi .	AUX PUNCT NOUN VERB PUNCT ADV ADJ DET NOUN VERB NOUN VERB PUNCT
Hayatımda gördüğüm en mantık lı insandı , attığı her adımdan önce o adımın sonuçlarını düşünürdü .	NOUN VERB ADV NOUN ADP VERB PUNCT ADJ DET NOUN ADP DET NOUN NOUN VERB PUNCT
Yıllarca süründükten sonra şans eseri bir gecede yıldızı parladı ve bu günlere geldi .	ADV VERB ADP NOUN ADJ DET NOUN NOUN VERB CCONJ DET NOUN VERB PUNCT
Film galasında giydiği modası geçmiş giysilerle hepimizin gözlerini kanattı .	DET NOUN VERB NOUN VERB PUNCT NOUN NOUN VERB PUNCT
Asosyal bir insan olması nedeniyle hiç arkadaşı yok tu , hep yalnızdı .	ADJ DET NOUN VERB NOUN ADV NOUN ADJ AUX PUNCT ADV VERB PUNCT
Düşmanca tavırları artık kendisine zarar vermeye başlamıştı , herkes ondan uzaklaşıyordu .	AUX PUNCT ADV ADJ NOUN VERB VERB PUNCT NOUN PRON VERB PUNCT
Aralarında kan davası bulunan iki ailenin düşmanlıkları bir türlü sona ermiyordu .	AUX PUNCT NOUN VERB PUNCT NOUN ADJ DET ADJ NOUN VERB PUNCT
Babası , annesini ve kendisini 10 yıl önce terk etmiş ve asla geri dönmemiş .	AUX PUNCT NOUN CCONJ ADJ DET NOUN ADP NOUN VERB CCONJ ADV ADJ VERB PUNCT
O kadar iğrenç bir insan ki hepimiz ondan nefret ediyoruz .	PRON ADP ADJ DET NOUN ADP VERB PUNCT NOUN VERB PUNCT
Yapılan araştırmalara göre Türkiye ' de yoksulluk oranı her geçen gün artıyor .	VERB VERB ADP VERB PUNCT CCONJ NOUN ADJ DET ADJ NOUN VERB PUNCT
Konferansta saçma söylemlerde bulunan kişiyi hiçkimse sevmiyordu .	ADV ADJ NOUN VERB PUNCT NOUN VERB PUNCT
Bursa - İzmir yolunda meydana gelen kazada 5 ölü , 6 yaralı bulunuyor .	PROPN PUNCT NOUN NOUN NOUN VERB PUNCT NOUN VERB PUNCT NOUN NOUN VERB PUNCT
Rivayete göre , Derecik köyünde bulunan lanet li eve girenler geri çıktıklarında psikolojileri bozuluyormuş .	NOUN VERB PUNCT NOUN NOUN VERB NOUN ADP NOUN ADV ADJ VERB NOUN VERB PUNCT
Uyuşturucu bağımlılığı her yıl milyonlarca gencin hayatını söndürüyor .	AUX PUNCT DET NOUN VERB PUNCT NOUN VERB PUNCT
Başımın ağrısı o kadar kuvvet liydi ki öleceğimi zannettim .	AUX PUNCT PRON ADP NOUN VERB ADP NOUN VERB PUNCT
Türkiye ' de toplumsal şiddet her geçen gün artıyor .	PROPN PUNCT CCONJ ADV ADJ DET ADJ NOUN VERB PUNCT
Karşıya geçmek isterken kamyonun altında kalan kadının hayatını kaybettiği anlar yayında .	ADJ VERB PUNCT NOUN ADJ VERB PUNCT NOUN VERB NOUN VERB PUNCT
O kadar antipatik bir insandı ki her gördüğümde yeniden tiksiniyordum .	PRON ADP ADJ DET NOUN ADP DET NOUN ADV VERB PUNCT
Egoist bir insan olduğu için onunla konuşmamayı tercih ediyorum .	ADJ DET NOUN VERB ADP VERB PUNCT NOUN VERB PUNCT
Kendini beğenmiş , burnu havada dolanan mızmızın teki ydi .	PRON VERB PUNCT NOUN NOUN VERB PUNCT ADJ AUX PUNCT
Her yıl kanserden dolayı ortalama 10 milyon ölüm gerçekleşiyor .	DET NOUN NOUN ADP ADJ VERB PUNCT NOUN VERB PUNCT
Korona yüzünden asosyal insanlara dönüştük , evden dışarı çıkamıyoruz .	DET NOUN ADJ NOUN VERB PUNCT NOUN NOUN VERB PUNCT
Onun , bugün derste hocaya yaptığı hareket çok saçma ydı .	AUX PUNCT NOUN NOUN NOUN VERB NOUN ADV ADJ AUX PUNCT
1 hafta dır yaptığı saçma hareketlerle beni kışkırtmaya çalışıyor , en sonunda kendime hakim olamayacağım .	NUM NOUN ADP VERB PUNCT NOUN PRON ADV VERB PUNCT ADV ADV ADJ NOUN VERB PUNCT
İzlediğimiz film o kadar korkunçtu ki kalp krizi geçirmemize ramak kalmıştı .	DET NOUN PRON ADP VERB ADP NOUN VERB PUNCT NOUN VERB PUNCT
Son günlerde gizli bir numara beni arayarak sürekli rahatsız ediyor .	ADJ NOUN ADJ DET NOUN PRON VERB ADV ADJ VERB PUNCT
Ona o kadar kızgınım ki bir daha yüzünü bile görmek istemiyorum .	PRON DET ADP VERB ADP DET NOUN NOUN ADV VERB VERB PUNCT
Yaptığı hatanın farkına varıp , düzeltmeden artık hayatımda ona yer yok .	VERB PUNCT NOUN VERB PUNCT PRON ADV NOUN PRON NOUN VERB PUNCT
Projemizden başarılı bir sonuç elde etmeyi dört gözle bekliyoruz .	ADV ADJ DET NOUN NOUN VERB PUNCT NOUN VERB PUNCT
Yarın planladığımız geziye ne yazık ki gidemeyeceğiz .	NOUN VERB PUNCT PRON VERB ADP VERB PUNCT
Burada ki markette istediğim markanın ürününü bulamadığım için şanssız hissediyorum .	NOUN ADP NOUN VERB PUNCT NOUN VERB ADP ADJ VERB PUNCT
Eyvah ! Hem Türkçe hem Matematik ödevimi yapmayı unuttum .	AUX PUNCT NOUN VERB CCONJ NOUN NOUN VERB VERB PUNCT
Bu eser serginin olmazsa olmaz eşsiz parçalarından birisi dir .	DET NOUN NOUN VERB VERB PUNCT NOUN PRON AUX PUNCT
Tüh ! Sınavda bu soruyu böyle çözmek aklıma bir türlü gelmedi .	AUX PUNCT ADJ DET NOUN ADV VERB PUNCT DET ADJ VERB PUNCT
Böyle büyük bir sorunla nasıl başa çıkacağımı hiç bilmiyorum .	ADV ADJ DET NOUN ADV VERB PUNCT ADV VERB PUNCT
Günün birinde bu kötü sır büyük bir olayın başlangıcı olacak .	AUX PUNCT DET ADJ NOUN ADJ DET NOUN NOUN VERB PUNCT
Böyle giderse bu ödevden iyi bir puan alamayacağız .	ADV ADJ DET NOUN ADJ DET NOUN VERB PUNCT
Küçüklüğümden beri voleybol oynamakla aram baya iyi dir .	AUX PUNCT NOUN VERB PUNCT ADV ADJ AUX PUNCT
Gelecekte çocuklarım için güven li ve sağlık lı bir yaşam diliyorum .	DET NOUN ADP NOUN ADP CCONJ NOUN ADP DET NOUN VERB PUNCT
Bu çiçekleri çabuk iyileşebilmen dileğiyle sana gönderdim .	DET NOUN ADJ VERB PUNCT PRON VERB PUNCT
Seneye iyi bir üniversitede okuyacağın için şimdiden tebrik ediyorum .	ADV ADJ DET NOUN VERB ADP NOUN NOUN VERB PUNCT
Yalan söylenmesinden hoşlanmadığımı bile bile bunu yaptığın için seni asla affetmeyeceğim .	ADJ VERB PUNCT ADV ADV ADJ VERB ADP PRON ADV VERB PUNCT
Böyle bir etkinlik için zaman ayırdığıma inanamıyorum .	ADJ DET NOUN ADP NOUN VERB VERB PUNCT
Yaptığınız kaba ve kötü davranışlar doğrultusunda işinize son vermek zorunda yım .	AUX PUNCT CCONJ ADJ DET NOUN NOUN ADJ VERB ADJ AUX PUNCT
Yarın ki doğum günü partimi düşündükçe heyecandan yerimde duramıyorum .	NOUN ADP NOUN NOUN NOUN VERB PUNCT NOUN VERB PUNCT
Günün bir kısmını kardeşlerimle geçirmek kadar güzel bir şey yok .	INTJ DET NOUN NOUN VERB ADP ADJ DET NOUN VERB PUNCT
En ufak bir olayda anında şiddete başvuran insanlardan haz etmiyorum .	ADV ADJ DET NOUN NOUN NOUN VERB PUNCT NOUN VERB PUNCT
Biraz önce duyduğum şey hayatımda ki en saçma fikirlerden biri ydi .	DET NOUN VERB NOUN NOUN ADP ADV ADJ NOUN PRON AUX PUNCT
Ne olursa olsun yanımda durmaktan vazgeçmediğin için teşekkür ederim .	PRON ADV VERB PUNCT NOUN VERB ADP NOUN VERB PUNCT
Beklediğim kadar iyi bir tecrübe edinemediğim için üzgünüm .	PRON ADP ADJ DET NOUN VERB ADP VERB PUNCT
Bugüne kadar yapmış oldukların arasında en berbat olanı bu ydu .	NOUN ADP VERB VERB PUNCT ADV ADJ NOUN PRON AUX PUNCT
Onun açısından düşününce bunun fayda lı olacağını düşünmüyorum .	PRON NOUN VERB PUNCT NOUN ADP ADJ VERB PUNCT
Onunla gözgöze geldiğimde nedenini bilmediğim bir şekilde donup kalmıştım .	DET NOUN VERB PUNCT ADJ DET NOUN NOUN VERB PUNCT
Mahsur kaldığımız orman zifiri karanlık ve çok tenha bir yerde olunca arkadaşım korkudan bayıldı .	ADJ VERB PUNCT NOUN VERB CCONJ ADV ADJ DET NOUN VERB PUNCT NOUN VERB PUNCT
Gideceğimiz yerde çok rahat bir şekilde yaşayabileceğimiz için bizden mutlusu yok .	DET NOUN ADV ADJ DET NOUN VERB ADP ADV ADJ VERB PUNCT
Başladığın bir işi bu kadar kusursuz yapılabileceğini hiç hayal etmemiştim .	INTJ DET NOUN DET ADP VERB PUNCT ADV NOUN VERB PUNCT
Durduğumuz dinlenme tesisi muhteşem bir manzaraya sahipti .	AUX PUNCT NOUN ADJ DET NOUN VERB PUNCT
Böyle bir durumla tek başına başa çıkabileceğini düşünmek akıl karı değildi .	ADJ DET NOUN ADJ DET NOUN VERB VERB PUNCT NOUN AUX PUNCT
Ailem yanımda olduğu sürece sırtımın yere gelmeyeceğini biliyorum ve seviniyorum .	ADV ADJ VERB PUNCT NOUN NOUN VERB VERB CCONJ VERB PUNCT
Annesi çocuğunun kötü bir şey yaptığını düşünmediği için onu uyarma gereği duymadı .	DET NOUN ADJ DET NOUN VERB VERB ADP PRON VERB NOUN VERB PUNCT
Başımdan geçen onca olaya rağmen iyi düşünmeye çalışıyorum .	ADV ADJ DET NOUN ADP ADJ NOUN VERB PUNCT
İnsanların bana dik dik bakması beni çok rahatsız ediyor .	NOUN PRON ADV ADJ VERB PRON ADV ADJ VERB PUNCT
Günün sonunda yine ben kazanmış olacağım için hiç olmadığım kadar mutluyum .	PRON ADV ADV PRON ADV VERB ADP ADV VERB ADP VERB PUNCT
Yaptığı hatayı telafi etmek için bu kadar çabaladığını görünce onun hakkında düşüncelerim iyi yönde değişti .	VERB PUNCT NOUN VERB ADP DET ADP NOUN VERB PUNCT NOUN NOUN ADJ NOUN VERB PUNCT
Hayatımda bir şeylerin yolunda gitmesi için daha ne kadar çabalamam gerektiği hakkında hiçbir fikrim yok .	ADJ DET NOUN NOUN VERB ADP ADV PRON ADP VERB PUNCT NOUN DET NOUN VERB PUNCT
Gün geçtikçe aramızda ki ilişkinin daha da büyümesi beni hiç olmadığım kadar mutlu ediyor .	NOUN VERB NOUN ADP NOUN ADV CCONJ NOUN PRON ADV VERB ADP ADJ VERB PUNCT
Güvendiğim kişilerle birlikte olunca hiçbir şüphe duymadan istediğim yolda yürümeye devam edebiliyorum .	DET NOUN ADP ADJ DET NOUN VERB VERB NOUN VERB NOUN VERB PUNCT
Sayısal analiz dersinin final sınavından 80 puan alıp dersi geçtiğim için çok mutlu yum .	AUX PUNCT NOUN NOUN VERB PUNCT NOUN VERB NOUN VERB ADP ADV ADJ AUX PUNCT
Bu yıl da geçen seneki gibi elemeleri geçip mülakata gireceğim için çok hevesli yim .	DET NOUN CCONJ ADJ NOUN ADP NOUN VERB NOUN VERB ADP ADV ADJ AUX PUNCT
Bu sene baharda havalar çok güzel olduğu için her hafta sonu pikniğe gittik .	DET NOUN NOUN NOUN ADV ADJ VERB ADP DET NOUN ADJ NOUN VERB PUNCT
Bugün ilk dersimiz beden eğitimi olduğu için kendimi enerjik hissediyorum .	NOUN ADJ DET NOUN NOUN VERB ADP PRON ADJ VERB PUNCT
Bu hafta sonu girdiğim ehliyet sınavı çok iyi geçtiği için yarın akşam arkadaşlarımla kutlama yemeğine çıkacağız .	DET NOUN ADJ VERB PUNCT NOUN ADV ADJ VERB ADP NOUN NOUN NOUN VERB NOUN VERB PUNCT
Bu sene Haziran ayında üniversiteden mezun olacağım için çok sevinçli yim .	DET NOUN NOUN NOUN NOUN ADJ VERB ADP ADV ADJ AUX PUNCT
Bu hafta pazar günü ailemle birlikte kahvaltıya çıkıp keyif li bir gün geçirdik .	DET NOUN NOUN NOUN NOUN ADP NOUN VERB NOUN ADP DET NOUN VERB PUNCT
Ayşe geçen sene gittiği ingilizce kursu sayesinde erasmus sınavını kazandı .	PROPN ADJ NOUN VERB PUNCT NOUN NOUN NOUN NOUN VERB PUNCT
Mahallede ki çocuklar okullarının bahçesine park yapıldığı için çok sevinçli görünüyorlar .	PRON ADP NOUN NOUN NOUN NOUN VERB ADP ADV ADJ VERB PUNCT
Bugün kedisinin 3 yaş doğum gününü kutlarken yeni kedi sahipleneceği haberini duyurduğu için çok mutlu ydu .	NOUN NOUN VERB PUNCT NOUN NOUN VERB ADJ NOUN VERB NOUN VERB ADP ADV ADJ AUX PUNCT
Düğünde giydiği siyah elbise onun üzerinde çok büyüle yici görünüyordu .	NOUN VERB PUNCT NOUN PRON NOUN ADV ADJ NOUN VERB PUNCT
İrem 23 Nisan Ulusal Egemenlik ve Çocuk Bayramı için yazdığı şiiri coşkulu bir şekilde okudu .	AUX PUNCT NOUN VERB PUNCT CCONJ NOUN NOUN ADP VERB PUNCT ADJ DET NOUN VERB PUNCT
Nazlı Kemal ' in evlilik teklifi için aldığı çiçekleri ve yüzüğü çok beğendiğini söyledi .	PROPN PROPN PUNCT NOUN NOUN NOUN ADP VERB PUNCT CCONJ NOUN ADV VERB VERB PUNCT
Geçen sene yazın ailem ile birlikte gittiğimiz Demet Akalın ve Hadise konseri muhteşemdi .	ADJ NOUN NOUN VERB CCONJ ADV VERB NOUN VERB CCONJ NOUN NOUN VERB PUNCT
Üstün başarılarından dolayı bu sene de ödül aldığı için kardeşi Fatma ile gurur duyuyordu .	DET NOUN ADP DET NOUN CCONJ NOUN VERB ADP NOUN VERB CCONJ NOUN VERB PUNCT
Yeni sahiplendiği kedinin sağlıklı olduğunu öğrendiğinden beri içi çok rahatladı .	ADJ VERB PUNCT NOUN VERB NOUN VERB PUNCT ADV VERB PUNCT
Şirkette ki başarılarından dolayı Alperen ' e onur ve başarı belgesi takdim edildi .	PRON ADP NOUN ADP VERB PUNCT NOUN VERB CCONJ NOUN NOUN NOUN VERB PUNCT
Sonunda ingilizce kursunun sınavında başarılı olup bir kur daha atlayabildiği için çok sevinçli ydi .	ADV ADJ DET NOUN ADJ VERB DET NOUN ADV VERB ADP ADV ADJ AUX PUNCT
Bu sene yapacakları projenin sonunda para ödülü verilecek olması onları motive etti .	DET NOUN VERB PUNCT ADV NOUN NOUN VERB VERB PUNCT NOUN VERB PUNCT
Okul hayatı boyunca başarılı bir öğrenci olup hep takdir belgesi almış .	DET NOUN ADP ADJ DET NOUN VERB PUNCT NOUN NOUN VERB PUNCT
Yaptığı ilk iş başvurusu kısa sürede kabul edilince sevinç çığlıkları atmaya başladı .	ADV ADJ NOUN NOUN ADJ NOUN NOUN VERB PUNCT NOUN VERB VERB PUNCT
Ali bu sene ilkokul 1 . sınıfa başlayacağı için çok heyecanlı ydı .	INTJ DET NOUN NOUN VERB PUNCT NOUN VERB ADP ADV ADJ AUX PUNCT
Bu yıl doğum gününde hediye ettiğim beyaz elbiseyi çok beğendiğini söyledi .	DET NOUN NOUN NOUN NOUN VERB PUNCT NOUN ADV VERB VERB PUNCT
Tatilde kaldığım 5 yıldızlı otelin balkonunun manzarasının güzelliği hala aklımdan çıkmıyor .	NOUN VERB PUNCT ADJ NOUN VERB PUNCT NOUN ADV NOUN VERB PUNCT
Geçtiğimiz yıl Ekim ayında bahçesine diktiği tüm fidanlar tuttuğu için çok mutlu .	DET NOUN NOUN NOUN NOUN VERB DET NOUN VERB ADP ADV ADJ PUNCT
Prison Break bugüne dek hayatımda izlediğim en kötü senaryolu dizi ydi .	AUX PUNCT NOUN VERB NOUN VERB ADV ADJ DET NOUN AUX PUNCT
Mehmet hasta olduğu için annesi bu hafta okula gelemeyeceğini söyledi .	ADV ADJ VERB ADP ADJ DET NOUN NOUN VERB VERB PUNCT
Ayşe bu sene kayak yaparken ayağını kırdığı için olimpiyatlara katılmayacak .	PROPN DET NOUN NOUN VERB NOUN VERB ADP NOUN VERB PUNCT
Derslerine çalışmayıp sınavda dereceye giremediği için bütün gün çok ağlamış .	AUX PUNCT NOUN NOUN VERB ADP ADJ NOUN ADV VERB PUNCT
2020 yılında korona virüs hastalığı başladığı için hiç güzel bir sene değildi .	NUM NOUN NOUN NOUN NOUN VERB ADP ADV ADJ DET NOUN AUX PUNCT
Çocukken mutfakta yaşadığım talihsizlikten dolayı yemek yapmayı hiç sevmiyorum .	DET NOUN VERB NOUN ADP NOUN VERB ADV VERB PUNCT
Yeni evine taşınırken çalışma masası kırıldığı için çok üzgün görünüyordu .	ADJ NOUN VERB PUNCT NOUN VERB ADP ADV ADJ VERB PUNCT
Çalıştığı fabrikada patronu kötü davrandığı için bu hafta istifa dilekçesini verecekmiş .	AUX PUNCT NOUN ADJ VERB ADP DET NOUN NOUN NOUN VERB PUNCT
Beyza bu hafta kar yağışı hiç durmadığı için iş seyahatine çıkamadı .	INTJ DET NOUN NOUN NOUN ADV VERB ADP NOUN NOUN VERB PUNCT
Kuzenim yeni aldığı bisikleti sürerken taşlı yollarda dengesini kaybedip düşmüş .	ADV ADJ VERB NOUN VERB PUNCT NOUN NOUN VERB VERB PUNCT
Bütün çocuklar babası ve annesi tartıştığı zaman bundan kötü etkilenip üzülür .	ADJ NOUN VERB CCONJ NOUN VERB NOUN ADV ADJ NOUN VERB PUNCT
Üniversite yemekhanesinde ki yemeklerin içinde çok fazla tuz olduğu için bugün kimse yemek yiyemedi .	DET NOUN ADP NOUN ADJ ADV ADJ NOUN VERB ADP NOUN NOUN NOUN VERB PUNCT
Köyde ki çiftçiler bu yıl kuraklıktan dolayı hasatın çok kötü geçtiğini söylediler .	PRON ADP ADJ DET NOUN NOUN ADP NOUN ADV ADJ NOUN VERB PUNCT
İzmir ' de çalıştığı dönemde geçirdiği trafik kazası sonucu amcam vefat etti .	PROPN PUNCT CCONJ DET NOUN VERB NOUN NOUN NOUN NOUN NOUN VERB PUNCT
Kötü hava koşullarından dolayı İstanbul Sabiha Gökçen havalimanında ki tüm uçuşlar iptal edildi .	DET NOUN NOUN ADP NOUN VERB PUNCT NOUN ADP DET NOUN NOUN VERB PUNCT
Kardeşim bu hafta içi girdiği futbol müsabakasını kaybettiği için çok ağladı .	INTJ DET NOUN ADJ VERB PUNCT NOUN VERB ADP ADV VERB PUNCT
Geçtiğimiz hafta yağmurlu havada yürüyüşe çıktığı için üşütüp hasta oldu .	DET NOUN ADJ NOUN NOUN VERB ADP ADV ADJ VERB PUNCT
İnternetten sipariş verdiğim ürün bir hafta dır kargoya verilmediği için siparişi iptal etmek zorunda kaldım .	DET NOUN VERB PUNCT DET NOUN ADP NOUN VERB ADP NOUN NOUN VERB ADJ VERB PUNCT
Bu sene İzmir ' de olan depremde binaların temelleri sağlam olmadığı için yıkılmış .	DET NOUN VERB PUNCT CCONJ VERB PUNCT NOUN NOUN ADJ VERB ADP VERB PUNCT
Kaldığım yurtta soğuk havalarda kaloriferleri açmadıkları için hasta oldum ve okula gidemedim .	DET NOUN ADJ NOUN NOUN VERB ADP ADJ VERB CCONJ NOUN VERB PUNCT
O projelerde etkin olarak rol üstlenen bir öğrenci olmadığı için düşük not aldı .	DET NOUN VERB ADP NOUN VERB DET NOUN VERB ADP ADJ NOUN VERB PUNCT
Kütahya ' da kaldığımız zaman yemekhanede yediğimiz yemeklerden zehirlendik ve hepimiz hasta olduk .	AUX PUNCT CCONJ DET NOUN VERB PUNCT NOUN VERB CCONJ ADV ADJ VERB PUNCT
Ayşe ikinci kez korona virüs hastalığına yakalandığı için çok mutsuzdu .	PROPN PUNCT NOUN NOUN NOUN NOUN VERB ADP ADV VERB PUNCT
Merdivenlerden inerken dengesini kaybedip yere düştü ve maalesef ayağı kırıldı .	AUX PUNCT NOUN VERB NOUN VERB CCONJ DET NOUN VERB PUNCT
Akşam yemeği için vermiş olduğum yemek siparişim çok geç geldiğinden dolayı yemekler soğumuştu .	NOUN NOUN ADP NOUN VERB NOUN NOUN ADV ADV VERB ADP NOUN VERB PUNCT
Geçen yıl doğum gününde iki arkadaşının birlikte aldığı çanta çok güzeldi .	ADJ NOUN NOUN NOUN VERB NOUN ADP VERB PUNCT ADV VERB PUNCT
Bu kitap son zamanlarda okuduğum en güzel ve etkile yici kitaptı .	DET NOUN ADJ NOUN VERB ADV ADJ CCONJ NOUN ADP VERB PUNCT
Yetenekli olduğu için ilkokul öğretmeninin yönlendirmesiyle severek resim çizmeye başlamıştı .	ADJ VERB ADP NOUN NOUN VERB PUNCT NOUN VERB VERB PUNCT
İstediği bölümü kazanmış olduğu için okulun açılmasını dört gözle bekliyordu .	DET NOUN VERB VERB ADP NOUN VERB PUNCT NOUN VERB PUNCT
Gökyüzünde ki uçakları izlerken hayal kurmak bugünlerde en çok sevdiği şeydi .	PRON ADP NOUN VERB NOUN VERB PUNCT ADV ADV VERB VERB PUNCT
Ailesine göre sesi güzel olduğu için şarkı söylemeyi çok seviyordu .	PRON ADP NOUN ADJ VERB ADP NOUN VERB ADV VERB PUNCT
Babasının da dediği gibi birkaç günlük tatil fikri fena değilmiş .	PROPN CCONJ VERB ADP DET NOUN NOUN NOUN ADJ AUX PUNCT
Burada ki anılarından uzaklaşmak hepsine çok iyi gelecektir .	NOUN ADP NOUN VERB PUNCT ADV ADJ VERB PUNCT
Yıllar dır o çok istediği motorsikleti karşısında görünce sevinçten havalara uçtu .	NOUN ADP PRON ADV VERB PUNCT ADJ VERB PUNCT NOUN VERB PUNCT
Bugün olduğu gibi yağmurlu havalarda yürüyüş yapmak hep iyi geliyordu .	NOUN VERB ADP ADJ NOUN NOUN VERB ADV ADJ VERB PUNCT
Doğum gününde sevdiklerinin kendisine aldığı hediyeleri gerçekten çok beğenmişti .	DET NOUN ADJ NOUN VERB PUNCT ADV ADV VERB PUNCT
Onun şu güne kadar yapmış olduğu en güzel yemek bu ydu .	PRON DET NOUN ADP VERB VERB ADV ADJ NOUN PRON AUX PUNCT
Murat yaşadığı son şeylerden sonra artık halinden gayet memnundu .	AUX PUNCT ADJ NOUN ADP ADV NOUN ADV VERB PUNCT
Yıllar dır almayı çok istediği kemanı sonunda aldığı için mutlu olmuştu .	NOUN AUX PUNCT ADV VERB PUNCT ADV VERB ADP ADJ VERB PUNCT
Sesi o kadar güzeldi ki dinleyen herkesi sesiyle büyülemeyi başarmıştı .	INTJ DET ADP VERB ADP VERB PUNCT NOUN VERB VERB PUNCT
Tuttukları takım şampiyon olunca taraftarların yaşadığı sevinç tarif edilemeyecek kadar büyük tü .	AUX PUNCT NOUN VERB NOUN VERB PUNCT NOUN VERB ADP ADJ AUX PUNCT
Okula gelmeden önce aldığı güzel haber ile artık içi içine sığmıyordu .	NOUN VERB ADP VERB ADJ VERB CCONJ ADV ADJ ADJ VERB PUNCT
Geçen gün beğenerek aldığı kırmızı montu ona gerçekten çok yakışmıştı .	ADJ NOUN VERB VERB PUNCT NOUN PRON ADV ADV VERB PUNCT
Aldığı haberle birlikte parlamaya başlayan yeşil gözleri mutluluğunu belli ediyordu .	DET NOUN ADP NOUN VERB PUNCT NOUN NOUN ADJ VERB PUNCT
Çok sevdiği bir arkadaşının almasıyla birlikte orkide artık en sevdiği çiçekti .	ADV ADJ DET NOUN VERB ADP NOUN ADV ADV VERB VERB PUNCT
Müzik dinleyerek yemek yapmak uzun zaman dır hobileri arasında bulunuyordu .	AUX PUNCT NOUN VERB ADJ NOUN ADP NOUN ADJ VERB PUNCT
Birkaç gün dür hasta olduğu için okula gelmeyen arkadaşının geleceğini duyunca sevindi .	DET NOUN ADV ADJ VERB ADP NOUN VERB NOUN ADJ NOUN VERB PUNCT
Geçen gün kırılan vazonun yenisi ile değiştirilmiş olduğunu görünce gülümsedi .	ADJ NOUN VERB NOUN VERB CCONJ NOUN VERB VERB VERB PUNCT
Defne yapılan bu güzel sürpriz karşısında heyecandan ne diyeceğini şaşırmıştı .	NOUN VERB DET ADJ NOUN ADJ NOUN PRON ADV VERB PUNCT
Burada ki herkesin yardımıyla kısa sürede büyük bir ailesi olduğu için mutlu ydu .	NOUN ADP NOUN NOUN ADJ NOUN ADJ DET NOUN VERB ADP ADJ AUX PUNCT
Bu sefer yaptığı yemek daha önce yaptıkları kadar güzel değildi .	DET NOUN VERB NOUN ADV ADV VERB ADP ADJ AUX PUNCT
Böyle bulutlu havalarda dışarı çıkmak ya da bir şey yapmak içinden gelmiyordu .	ADV ADJ NOUN NOUN VERB CCONJ CCONJ DET NOUN VERB ADJ VERB PUNCT
Üşüyen ellerini soğuktan korumak için taktığı eldivenlerini nereye koyduğunu bilmiyordu .	AUX PUNCT NOUN VERB ADP VERB PUNCT PRON ADV VERB PUNCT
Arkadaşı ; yıllar dır kullandığı ve onun için değerli olan kalemi kaybetmişti .	AUX PUNCT NOUN ADP VERB CCONJ PRON ADP ADJ VERB NOUN VERB PUNCT
İnsanların sürekli ona yalan söyleyip bir şeyler saklamasından nefret ediyordu .	NOUN ADV PRON ADJ VERB DET NOUN VERB NOUN VERB PUNCT
Ailesinden ayrılıp üniversite okumak için geldiği bu şehirde çok yalnızdı .	AUX PUNCT NOUN VERB ADP VERB DET NOUN ADV VERB PUNCT
Bu yarışmada çizdiği resim şuana kadar ki en iyi çalışması değildi .	DET NOUN VERB NOUN NOUN ADP CCONJ ADV ADJ VERB AUX PUNCT
Yapmak isteyip de yapmaya fırsat bulamadığım çok şey var , dedi .	ADV VERB CCONJ DET NOUN VERB ADV NOUN VERB PUNCT VERB PUNCT
Henüz ehliyeti olmadığı için araba kullanamıyor oluşu onu gerçekten üzüyordu .	DET NOUN VERB ADP NOUN VERB PUNCT PRON ADV VERB PUNCT
Son yaşananlardan sonra burada olmak kendini kötü hissetmesine sebep oluyordu .	ADJ VERB ADP NOUN VERB PUNCT ADJ DET NOUN VERB PUNCT
Onu hiçbir şey olmamış gibi karşısında görünce öfkeden deliye döndü .	PRON DET NOUN VERB ADP ADJ VERB PUNCT NOUN VERB PUNCT
Bu yaptığı şey onun için elinden gelenin en iyisi değildi .	PRON VERB NOUN PRON ADP NOUN VERB ADV ADJ AUX PUNCT
Uzun zaman sonra birlikte gittikleri yerde güzel vakit geçirmiş sayılmazdı .	ADJ NOUN ADP VERB PUNCT NOUN ADJ NOUN VERB VERB PUNCT
Bu konuda ki davranışları diğerlerinin aksine hiç yaşına göre uygun değildi .	DET NOUN ADP NOUN VERB PUNCT ADV VERB ADP ADJ AUX PUNCT
Durumun iyi olacağına dair küçük bir umudu dahi yok tu artık .	ADV ADJ VERB PUNCT ADJ DET NOUN ADJ ADJ NOUN VERB PUNCT
Okula gelirken giydiği mavi gömlek ile hiç de iyi görünmüyordu	NOUN VERB PUNCT NOUN VERB CCONJ ADV CCONJ ADJ VERB
Ödeve başlarken sonrasında neler yapması gerektiğini düşünmek bile istemiyordu .	NOUN VERB PUNCT NOUN VERB VERB PUNCT ADV VERB PUNCT
İki yıl önce gittiği konsere göre bu yılki konser iyi bile değildi .	NUM NOUN ADV VERB NOUN ADP DET NOUN NOUN ADJ VERB AUX PUNCT
Sipariş ettiği kitaplar baskısı olmadığı için bir ay geç geldi .	NOUN VERB PUNCT NOUN VERB ADP DET NOUN ADV VERB PUNCT
Çalan şarkı ile birlikte aklına gelenler yüzünden gözleri dolmuştu .	DET NOUN VERB ADP NOUN ADJ NOUN NOUN VERB PUNCT
Evden gelen sesler ile birlikte hırsız girdiğini düşünüp çok kokrmuştu .	NOUN VERB PUNCT CCONJ ADV ADJ VERB PUNCT ADV VERB PUNCT
Babasının bu doğum gününde aldığı oyuncak araba önceki ler kadar iyi değildi .	INTJ DET NOUN NOUN VERB PUNCT NOUN NOUN VERB ADP ADJ AUX PUNCT
Hep birlikte gideceğimiz müze gezisinin salgın nedeniyle iptal olması bizi üzdü .	ADV ADJ VERB PUNCT NOUN NOUN NOUN NOUN VERB PRON VERB PUNCT
Begüm ablasıyla birlikte izlediği filmden çok etkilenmiş günlerce ağlamıştı .	DET NOUN ADP VERB PUNCT ADV VERB NOUN VERB PUNCT
Gün geçtikçe hayata dair umutlarının artık tamamen tükendiğini düşünüyordu	NOUN VERB NOUN VERB PUNCT ADV ADV ADJ VERB
Kendimde ki ve etrafımda ki olayları gün geçtikçe daha iyi anlamaya başlıyoru m	NOUN ADP CCONJ NOUN ADP NOUN NOUN VERB ADV ADJ VERB PUNCT NOUN
Bazıları müzik dinlemekten , bazıları da resim yapmaktan hoşlanır .	DET NOUN VERB PUNCT PRON CCONJ NOUN VERB VERB PUNCT
Bu akşam Ahmet ve Selin ile dışarıda meyhaneye gideceğiz .	DET NOUN VERB CCONJ VERB CCONJ NOUN NOUN VERB PUNCT
Enver bey , projemiz hakkında sizi detaylı olarak bilgilendirece k	ADV VERB PUNCT NOUN NOUN PRON VERB ADP VERB NOUN
Dün akşam babamla birlikte harika bir kovboy filmi izledi k	NOUN NOUN NOUN ADP ADJ DET NOUN NOUN VERB NOUN
En zor anında insanın yanında olan ailesi ve dostlarıymı ş	ADV ADJ NOUN NOUN ADJ VERB PUNCT CCONJ DET NOUN
Aklımda nice dir gerçekleştirmek istediğim birçok hayal var .	ADV ADJ AUX PUNCT VERB DET NOUN VERB PUNCT
İnan ben de çocukluğumun geçtiği sokakları çok özledi m	CCONJ PRON CCONJ NOUN VERB PUNCT ADV VERB NOUN
Öğretmenin sorduğu tüm sorulara doğru yanıt ver di	AUX PUNCT DET NOUN ADJ NOUN VERB PUNCT
Önce arabanın ruhsatını verdi , sonra parayı alıp anahtarı verdi .	DET NOUN NOUN VERB PUNCT ADP NOUN VERB NOUN VERB PUNCT
Freelance yaparak " Digital Nomad " olmak istiyoru m	ADV VERB PUNCT NOUN VERB PUNCT VERB PUNCT NOUN
İki gün sonra benim maaş hesabıma yatmış olacak ondan sonra gezmeye gidebiliriz	NUM NOUN ADP PRON VERB PUNCT NOUN VERB PRON ADP VERB PUNCT
Yarın Charlotte Cardin konseri olacak beraber gide li m	NOUN VERB PUNCT NOUN VERB PUNCT NOUN ADP NOUN
3D yazıcı alıcak param var artık	NUM NOUN VERB NOUN ADJ ADV
Arkadaşlarla bu akşam toplanıp FRP oynadık	INTJ DET NOUN VERB NOUN VERB
Bugün fransızcada kendimi biraz daha geliştirdiğimi hissediyoru m	NOUN NOUN PRON ADV ADV VERB PUNCT NOUN
Artık yurtdışına çıkabilecek param var ve ilk olarak İtalya ' ya gideceği m	ADV ADJ DET NOUN VERB CCONJ ADJ ADP VERB PUNCT CCONJ DET NOUN
Artık havalar baya ısınmaya başladı kış bitmiş gibi	DET NOUN NOUN VERB VERB NOUN VERB ADP
Seni mutlu görmek beni mutlu ediyor	PRON ADJ VERB PRON ADJ VERB
Kedim kanserini atlattı artık rahatlayabiliriz	NOUN VERB PUNCT ADV VERB
Bu akşam baya lezzet li ve doyurucu bir yemek yedi k	DET NOUN NOUN NOUN ADP CCONJ ADJ DET NOUN VERB NOUN
Erasmusa seçilmişim diğer dönem Almanya ' da okuyacağı m	AUX PUNCT ADJ NOUN VERB PUNCT CCONJ DET NOUN
Su samurları aşırı tatlı hayvanlar	DET NOUN ADJ NOUN VERB
Dün Ramstein yeni teklisi çıkmış ve aşırı güzel olmuş .	NOUN ADV ADJ NOUN VERB CCONJ ADJ ADJ VERB PUNCT
Yeni bir hobi edindim o da figür tasarımı .	ADJ DET NOUN VERB PUNCT CCONJ NOUN VERB PUNCT
Sağ ayağıma artık düzgün basamıyorum .	DET NOUN ADV ADJ VERB PUNCT
Maaşım artık bana yetmemeye başladı	PRON ADV PRON ADV VERB
Bana sorarsan bu problemi öğretmen dahi çözemez	PRON VERB DET NOUN NOUN ADJ VERB
3D yazıcımın ucunda arıza çıktı artık düzgün çalışmıyor	NUM NOUN NOUN NOUN VERB ADV ADJ VERB
Senin kitabını almak istemiyorum bana hitap etmiyor .	DET NOUN VERB PUNCT PRON NOUN VERB PUNCT
Trafik tıkandığı için vaktinde yetişemeyeceği m	NOUN VERB ADP NOUN VERB NOUN
Pazardan aldığım meyveler ne kadar lezzetsizmi ş	NOUN VERB PUNCT PRON ADP NOUN NOUN
Onun büyük sorun yaşamasına neden olan hastalığı sebebiyle çok fazla mutsuzdu m	PRON ADJ NOUN VERB NOUN VERB PUNCT NOUN ADV ADJ VERB NOUN
Bu bölgede misafir olabileceğimiz tek bir ev bile yok tu .	DET NOUN NOUN VERB ADJ DET NOUN ADV ADJ AUX PUNCT
Bu beli bükük yaşlı adam aslında düşündüğünüz haklı değildi	DET NOUN VERB PUNCT NOUN ADV VERB ADJ AUX
Fransızca çalışmaktan hiç zevk almıyoru m	AUX PUNCT ADV NOUN VERB NOUN
Dün akşam televizyonda çıkan filmden hiç zevk alamadı m	NOUN NOUN NOUN VERB PUNCT ADV NOUN VERB NOUN
Bu kitapta ki ana karakterin babası çok itici bir insan	DET NOUN ADP ADJ DET NOUN ADV ADJ DET NOUN
Dün kü konser baya sıkıcı ydı	NOUN ADP NOUN ADV ADJ AUX
Sabah yaptığım yemeği sevgilim hiç beğenmedi	NOUN VERB NOUN NOUN ADV VERB
Dün arkadaşım arabası ile kaza yapmı ş	NOUN NOUN VERB CCONJ NOUN VERB NOUN
Aldığım buzdolabı bu sabah bir anda sessizleşip bozuldu	AUX PUNCT DET NOUN DET NOUN VERB VERB
Ankaranın yolları çok taşlı ymı ş	AUX PUNCT ADV ADJ DET NOUN
Bu akşam ki planımız iptal olmu ş	DET NOUN ADP NOUN NOUN VERB NOUN
Sporda yken belimi sakatlamışım artık düzgün kalkamıyoru m	AUX PUNCT NOUN VERB ADV ADJ DET NOUN
Ödevi yaparken artık elim ağrımaya başladı	NOUN VERB ADV ADJ NOUN VERB
Malesef yarın gelemeyeceğim babam hastalandı	DET NOUN VERB NOUN VERB
Acaba bu ay sonunu getirebilecek miyim hiç bilmiyoru m	INTJ DET NOUN ADJ VERB PUNCT ADV VERB NOUN
Venom filmi baya kötüymü ş	DET NOUN NOUN VERB NOUN
Dün yemeği yaparken yemeği yakmışı m	NOUN NOUN VERB NOUN VERB NOUN
Artık burada yaşamak istemiyoru m	DET NOUN VERB PUNCT NOUN
Koltuğa doğru yürürken masanın üzerinde ki fotoğraf dikkatimi çekti , ne kadar da tatlıymışsın !	ADV ADJ VERB PUNCT NOUN ADP NOUN NOUN VERB PUNCT PRON ADP CCONJ VERB PUNCT
Dürüst olmak gerekirse benim de kalbim ona karşı boş değil .	ADJ VERB PUNCT PRON CCONJ NOUN PRON ADP ADJ AUX PUNCT
Kafamın içinde bu bahsettiğin konulara benzer düşünceler yok dersem yalan olur .	ADV ADJ DET NOUN NOUN VERB PUNCT ADJ VERB ADJ VERB PUNCT
Dün akşam babamla birlikte kovboy filmi izlerken harika vakit geçirdim .	NOUN NOUN NOUN ADP NOUN NOUN VERB ADJ NOUN VERB PUNCT
Çiçekleri genel olarak sevsem de papatyayı bir ayrı seviyorum diyebilirim .	DET NOUN ADP VERB CCONJ ADJ DET NOUN VERB VERB PUNCT
Eskiden öğrenmekte zorlandığım konuyu , bu kurs sayesinde kolayca öğrenmiş oldum .	AUX PUNCT NOUN VERB PUNCT DET NOUN NOUN VERB NOUN VERB PUNCT
Geçen cumartesi günü gittiğiniz okulun tanışma partisine çağırsaydın gelmez miydim ?	ADJ DET NOUN VERB NOUN VERB PUNCT NOUN VERB VERB PUNCT
Sesi duyup sokağa çıkan yaşlılar , iş makinesinin çalışmasını izlerken adeta büyülenmişlerdi .	AUX PUNCT NOUN VERB VERB PUNCT NOUN NOUN VERB PUNCT ADV VERB PUNCT
Telefon uygulamasından söylemiş olduğum yemek düşündüğümden lezzetli ydi ve hızlı gelmişti .	DET NOUN VERB VERB NOUN VERB ADJ AUX CCONJ ADJ VERB PUNCT
Yeni çıkan oyununu aldığı kullanıcı puanları beklenilenden çok daha iyi ydi .	ADJ VERB NOUN VERB PUNCT NOUN NOUN ADV ADV ADJ AUX PUNCT
Derse yetişmem için yakalamam gereken son otobüsü yakalamayı başardım ve derse yetiştim .	NOUN VERB ADP VERB PUNCT ADJ NOUN VERB PUNCT CCONJ NOUN VERB PUNCT
Yazar elinde bulundurduğu bu seriye adeta yeni bir soluk getirmiş .	DET NOUN VERB DET NOUN ADV ADJ DET NOUN VERB PUNCT
Elimde ki verilere baktığımda projemizi yaparken başarılı bir yolda olduğumuzu söyleyebilirim .	PRON ADP NOUN VERB NOUN VERB ADJ DET NOUN VERB VERB PUNCT
Film şirketi , son filmi ile elinde ki markayı ne kadar doğru kullanmış .	NOUN VERB PUNCT ADJ NOUN CCONJ NOUN ADP NOUN PRON ADP ADJ VERB PUNCT
Marka hakkı sebebiyle açılan davada kendini doğru bir şekilde savunmuş .	DET NOUN NOUN VERB PUNCT PRON ADJ DET NOUN VERB PUNCT
Yağmur sonrası dışarıda ki o hava insanın içini ısıtıyor ve insanı mutlu ediyor .	DET NOUN NOUN ADP DET NOUN NOUN ADJ VERB CCONJ NOUN ADJ VERB PUNCT
Yaptığım bazı araştırmalar , beni ilgi alanım konusunda daha da motive etmiş durumda .	DET NOUN VERB PUNCT PRON VERB PUNCT NOUN ADV CCONJ NOUN VERB NOUN PUNCT
Okulumuzu temsil eden takımımız bilgi yarışmasından derece ile ayrılmış bulunmakta .	DET NOUN VERB PUNCT NOUN NOUN VERB CCONJ NOUN VERB PUNCT
Anneler günü için aldığım buketi annem çok beğendi ve beni yanağımdan öptü .	DET NOUN ADP VERB PUNCT NOUN ADV VERB CCONJ PRON NOUN VERB PUNCT
Bugün arkadaşlarımla kafenin üst katında oynadığım oyundan fazlasıyla zevk aldım .	NOUN NOUN NOUN ADJ NOUN VERB PUNCT ADV NOUN VERB PUNCT
Bir süre dir almayı beklediğim bilgisayar indirime girmiş , artık alabilirim diye düşünüyorum .	DET NOUN AUX PUNCT VERB PUNCT NOUN VERB PUNCT ADV VERB ADP VERB PUNCT
Uzun süre ve emek harcadığım projemin son aşamasında yım , başarmama az kaldı .	ADJ NOUN CCONJ NOUN VERB PUNCT ADJ NOUN VERB PUNCT ADV ADJ VERB PUNCT
Kişisel gelişim üzerine gittiğim oturum benim için fazlasıyla yararlı oldu .	AUX PUNCT NOUN VERB PUNCT PRON ADP ADV ADJ VERB PUNCT
Severek takip ettiğim bir iş adamı , kariyerime etkisi olacak önem li bir yazı paylaştı .	DET NOUN VERB DET NOUN VERB PUNCT NOUN NOUN VERB NOUN ADP DET NOUN VERB PUNCT
Üniversite zamanı kalmak için tuttuğum evin sahibi ile tanıştım ve kendisi çok nazik biri .	DET NOUN VERB ADP VERB NOUN VERB CCONJ VERB CCONJ PRON ADV ADJ VERB PUNCT
Küçük kardeşimle birlikte oyun oynarken kardeşim beni ittirdi , vazo kırıldı .	ADJ NOUN ADP NOUN VERB PUNCT PRON VERB PUNCT NOUN VERB PUNCT
Dün gece yağmur yağdığı için yerler ıslanmıştı , dolayısıyla parka gidemedi m	NOUN NOUN NOUN VERB ADP NOUN VERB PUNCT NOUN NOUN VERB NOUN
Bu problem çok zor görünüyor , bana sorarsan bunu öğretmen dahi çözemez .	DET NOUN ADV ADJ VERB PUNCT PRON VERB PUNCT NOUN ADJ VERB PUNCT
Okulun hazırladığı gösteriye , işte oldukları için ne annem ne de babam gelebildi .	NOUN VERB VERB PUNCT ADV VERB ADP PRON NOUN PRON CCONJ NOUN VERB PUNCT
Gözlerimin içine bak ve söyle , böyle olmasını ben mi istedim ?	ADV ADJ VERB CCONJ VERB PUNCT ADV VERB PRON ADV VERB PUNCT
Başımıza ne işler açtın sen , çık çıkabilirsen bu işin içinden .	CCONJ PRON NOUN VERB VERB PUNCT ADV ADJ DET NOUN VERB PUNCT
Sabah evimden okuluma gelirken otobüste tatsız bir olayla karşılaştım .	NOUN NOUN NOUN VERB PUNCT ADJ DET NOUN VERB PUNCT
Sınıfımda ki Ahmet , projelerde etkin bir rol üstlenen bir öğrenci değil .	PRON ADP VERB PUNCT NOUN ADJ DET NOUN VERB DET NOUN AUX PUNCT
Dayım , saatini kurmayı unuttuğu için otobüse yetişemedi ve işe geç kaldı .	AUX PUNCT NOUN VERB VERB ADP NOUN VERB CCONJ NOUN ADV VERB PUNCT
Telefon uygulamasından söylemiş olduğum yemek , uygulamada yazan süreden geç geldi .	DET NOUN VERB VERB NOUN PUNCT NOUN VERB PUNCT ADV VERB PUNCT
Yeni çıkan oyununu aldığı puanlar gösteriyor ki , beklentiyi karşılayamamış durumdalar .	ADJ VERB NOUN VERB NOUN VERB ADP PUNCT NOUN VERB VERB PUNCT
Dediklerine bakacak olursak ağzından çıkanı kulağın duymuyor olmalı haksız mıyım ?	DET NOUN VERB PUNCT NOUN NOUN VERB PUNCT NOUN VERB PUNCT
Telefonumun şarjı eve gidene kadar dayanamadı ve şu an kimseyi arayamıyorum .	NOUN NOUN NOUN VERB ADP VERB CCONJ DET NOUN NOUN VERB PUNCT
Yarın için olan ödevimi yaparken elektriklerin kesilmesi sebebiyle ödevimi yetiştiremeyeceğim .	NOUN ADP VERB NOUN VERB NOUN VERB NOUN NOUN VERB PUNCT
Alışveriş sitesinden siparişini verdiğim tekerlekli sandalye yine zamanında bana ulaşmayacak .	AUX PUNCT NOUN VERB PUNCT NOUN ADV NOUN PRON VERB PUNCT
Çok sevdiğim bir yakın dostumla ettiğimiz tartışma sonucu birbirimize küstük .	ADV VERB DET NOUN NOUN VERB PUNCT NOUN NOUN VERB PUNCT
Kardeşim ders çalışırken beni sürekli rahatsız ediyor , konularımı yetiştirmekte zorlanıyorum .	DET NOUN VERB PRON ADV ADJ VERB PUNCT NOUN VERB VERB PUNCT
Çantamda ki su patlamış , defterlerim ıslanmış , notlarım kullanılamaz hale gelmiş durumda .	PRON ADP NOUN VERB PUNCT NOUN VERB PUNCT NOUN VERB NOUN VERB NOUN PUNCT
Yemekhane sırasının uzunluğu sebebiyle sıra bana geldiğinde tatlı alamamış oldum .	AUX PUNCT NOUN NOUN NOUN PRON ADV ADJ VERB VERB PUNCT
Kullandığım para biriminin değer kaybetmesi sonucu almak için para biriktirdiğim gitarı alamadım .	DET NOUN NOUN NOUN VERB NOUN VERB ADP NOUN VERB NOUN VERB PUNCT
Arkadaşımı ne kadar sevsem de güzel olmayan sesi ile şarkı söylemesi beni rahatsız ediyor .	CCONJ PRON ADP VERB CCONJ ADJ VERB PUNCT CCONJ NOUN VERB PRON ADJ VERB PUNCT
Sokaklarda evsiz insanları görmek beni üzüyor ve gelecek hakkında endişelendiriyor .	AUX PUNCT NOUN VERB PRON VERB CCONJ DET NOUN VERB PUNCT
Kendisi ne kadar iyi bir insan olsa da öfke sorunları var .	CCONJ PRON ADP ADJ DET NOUN VERB CCONJ NOUN NOUN VERB PUNCT
Kirasını karşılayamayacak hale geldiğim için daha düşük fiyat lı bir ev bulmalıyım .	AUX PUNCT NOUN VERB ADP ADV ADJ NOUN ADP DET NOUN VERB PUNCT
Uzak mesafede oturduğum için sabah erken kalkmak fazlasıyla yorucu oluyor .	DET NOUN VERB ADP NOUN ADV VERB ADV ADJ VERB PUNCT
Masada ki yükseklik sorununu henüz çözememişsin .	PRON ADP NOUN NOUN ADV VERB PUNCT
Bu aralar baya şanssızım sanırım .	DET NOUN NOUN NOUN VERB PUNCT
Bunca yoldan sonra eve nerede yse varamıyorduk .	ADJ NOUN ADP NOUN PRON ADV VERB PUNCT
Otobüse binmek beni artık pek de yormuyor .	AUX PUNCT PRON ADV ADV CCONJ VERB PUNCT
Açken yemek yiyince enerjimi geri kazanıyorum .	DET NOUN VERB PUNCT ADJ VERB PUNCT
Rahatlıkla dinlenirken nelerle karşılaşacağını bilmiyordu arkadaşımız .	NOUN VERB PUNCT NOUN VERB VERB PUNCT
Bir programlama dilini öğnrendikten sonra diğerlerini öğrenmek çok daha kolay geliyor .	DET NOUN NOUN VERB ADP NOUN VERB ADV ADV ADJ VERB PUNCT
Kalemimin ucunu değiştirmesi , içinde ki mekanik kısım sıkıntılı olduğundan zor oluyor .	DET NOUN VERB PUNCT ADJ ADP ADJ DET NOUN VERB ADJ VERB PUNCT
Bunca çalışma ve emekten sonra nihayet tüm derslerini geçebilmişti .	ADJ VERB CCONJ NOUN ADP ADJ DET NOUN VERB PUNCT
Bilgisayarında ki temizlikten sonra cihazın performansı büyük ölçüde arttı .	PRON ADP NOUN ADP NOUN NOUN ADJ NOUN VERB PUNCT
Gitar çalmayı çok istemişti ancak öğrenmesi ona çok zor gelmişti .	AUX PUNCT ADV VERB CCONJ NOUN PRON ADV ADJ VERB PUNCT
Botlarımı giyip yağmurlu havalarda yürüyüş yapmak çok sakinleştiri ci geliyor .	AUX PUNCT ADJ NOUN NOUN VERB ADV ADJ NOUN VERB PUNCT
Kasa bilgisayarlar daha sessiz ve soğuk olsalar da dizüstü bilgisayarları daha çok seviyorum .	AUX PUNCT ADV ADJ CCONJ ADJ VERB CCONJ DET NOUN ADV ADV VERB PUNCT
RGB ekipmanları sevsem de fazla ışıklar beni çok rahatsız ediyor .	DET NOUN VERB CCONJ ADV NOUN PRON ADV ADJ VERB PUNCT
Bilgisayar oyunları oynamak toplumca güzel karşılanmıyor .	DET NOUN VERB PUNCT ADJ VERB PUNCT
Anladığım kadarıyla yazılımcılar , yazılımcı kimliklerini seviyor ve benimsiyorlar .	DET NOUN VERB PUNCT NOUN NOUN VERB CCONJ VERB PUNCT
Şirketlerin acımasız politikalarını insanlar sevmiyorlar .	ADV ADJ DET NOUN VERB PUNCT
Ama yine de son çıkan pahalı ürünleri almayı herkes çok istiyor .	CCONJ ADV CCONJ ADJ VERB PUNCT NOUN VERB NOUN ADV VERB PUNCT
İnsanlar sanatsal çalışmalarıın görsellik kısmını severler .	DET NOUN VERB PUNCT NOUN VERB PUNCT
Eski dönemin kıyafetlerı sonra ki nesiller tarafından sevilmezler .	ADJ DET NOUN ADP CCONJ NOUN NOUN VERB PUNCT
Bazı insanlar fazla hareket gerektiren aktivitelere bayılıyorlar .	DET NOUN ADV NOUN VERB NOUN VERB PUNCT
Çoğu insan yüksek mekanlarda bulunmayı güven li bulmaz .	DET NOUN ADJ NOUN VERB NOUN ADP VERB PUNCT
Dar sokaklar genelde insanlara güven vermezler .	DET NOUN ADV ADJ NOUN VERB PUNCT
Denizin olduğu şehirler olmadığı şehirlere göre çok daha fazla sevilir .	NOUN VERB NOUN VERB NOUN ADP ADV ADV ADJ VERB PUNCT
Tır kullanmak ve yük taşımanın birçok kişi tarafından sevilir .	NOUN VERB CCONJ NOUN VERB DET NOUN NOUN VERB PUNCT
Aksiyon oyun ve filmlerinin halk nazarında kişilere kötü etkisi olduğu düşünülür .	DET NOUN CCONJ NOUN VERB PUNCT NOUN ADJ NOUN VERB VERB PUNCT
Kitap okumak yararlı görülse de çoğu kişi için eğlence li değildir .	NOUN VERB ADJ VERB CCONJ DET NOUN ADP NOUN ADP AUX PUNCT
Bazı romanların olayları fazla uzatması beni o romandan soğutuyor .	DET NOUN NOUN ADV VERB PRON DET NOUN VERB PUNCT
Yazılım yazdıkça alınan haz genelde artıyor .	NOUN VERB PUNCT NOUN ADV VERB PUNCT
Orta seviye kas bence nerede yse herkesde çok güzel görünüyor .	DET NOUN VERB PUNCT PRON AUX PUNCT ADV ADJ VERB PUNCT
Rap müziğin bu kadar popüler olmasını hiç anlamıyorum .	AUX PUNCT DET ADP ADJ VERB ADV VERB PUNCT
Küçük ama çok işlevsel alet ve cihazlara hayranım .	ADJ CCONJ ADV ADJ VERB CCONJ NOUN VERB PUNCT
Bir yerlere giderken yavaş yürüyen insanları hiç anlayamıyorum .	DET NOUN VERB ADJ DET NOUN ADV VERB PUNCT
Kar yağdığında kar taneleri havada ki sesi tutuyor , ve o sessizlik çok hoşuma gidiyor .	AUX PUNCT NOUN NOUN NOUN ADP NOUN VERB PUNCT CCONJ DET NOUN ADV NOUN VERB PUNCT
Yemek sektöründe ki zararlı maddeleri bildikten sonra paket li yiyeceklere sıcak bakmıyorum .	DET NOUN ADP ADJ NOUN VERB ADP NOUN ADP NOUN ADJ VERB PUNCT
Gözlük takmak lens takmaya kıyasla çok daha iyi bana kalırsa .	AUX PUNCT NOUN VERB PUNCT ADV ADV ADJ PRON VERB PUNCT
Bazı angarya ödevleri yapmak beni çok sıkıyor .	DET NOUN NOUN VERB PRON ADV VERB PUNCT
Evde ki sakinlik ve rahatı başka bir şeye değişmem .	NOUN ADP VERB CCONJ NOUN ADJ DET NOUN VERB PUNCT
Klavye ile çok hızlı yazı yazmaya bayılıyorum .	PROPN CCONJ ADV ADJ NOUN VERB VERB PUNCT
Türkçe klavyeyi kodlamada ki özel karakterleri yazması zor olduğundan sevmiyorum .	PROPN NOUN VERB ADP ADJ NOUN VERB ADJ VERB VERB PUNCT
Birçok insanın aksine çok büyük monitörler beni hiç çekmiyor .	DET NOUN ADV ADV ADJ NOUN PRON ADV VERB PUNCT
Mekanik klavyeler çok ses çıkarmasa da hissiyatlarından dolayı seviyorum .	AUX PUNCT ADV NOUN VERB CCONJ NOUN ADP VERB PUNCT
Yakın zamanda ışık hızına ulaşacak teknolojiye varabileceğimizi hiç sanmıyorum .	DET NOUN NOUN NOUN VERB PUNCT PRON ADV VERB PUNCT
İnternet esprileri beni genelde çok güldürüyor .	AUX PUNCT PRON ADV ADV VERB PUNCT
Bilgisayarların işleyişini öğrenmek bulmaca çözmek kadar zevk veriyor .	DET NOUN VERB NOUN VERB ADP NOUN VERB PUNCT
Temizliğine dikkat etmeyen insanları hiç anlamıyorum .	DET NOUN VERB NOUN ADV VERB PUNCT
Bu ödev neden hala bitmiyor anlayamıyorum .	DET NOUN PRON ADV ADJ VERB PUNCT
Bu ödev bitince galiba inanılmaz mutlu olacağım .	DET NOUN VERB PUNCT ADV ADJ VERB PUNCT
Uğurböceği hariç çoğu böceği sevmiyorum , hatta nerede yse tiksiniyorum .	ADV ADJ DET NOUN VERB PUNCT NOUN PRON ADV VERB PUNCT
Sokak hayvanlarının sakin ve umursamaz bakışları çok tatlı geliyor .	DET NOUN VERB CCONJ DET NOUN ADV ADJ VERB PUNCT
Çok uzun bir aradan sonra tekrar ata binecekleri için mutlu ydu .	ADV ADJ DET NOUN ADP ADV ADJ VERB ADP ADJ AUX PUNCT
Annemin kardeşimin doğum günü için kendi elleriyle hazırladığı pasta şahane gözüküyor .	AUX PUNCT NOUN NOUN ADP NOUN NOUN VERB PUNCT NOUN VERB PUNCT
Yıllar dır tuttuğu takımı canlı bir şekilde binlerce insanın arasında izlemek heyecan verici ydi .	NOUN ADP VERB PUNCT ADJ DET NOUN VERB NOUN ADJ VERB NOUN NOUN AUX PUNCT
Kendi ayakları üstünde durmak isteyen bir kadın olarak bu habere çok sevinmişti .	PRON ADV ADJ VERB PUNCT DET NOUN ADP DET NOUN ADV VERB PUNCT
Konserde en sevdiğim sanatçıyla beraber şarkı söylerken kalbim duracak gibi ydi .	PRON ADV VERB PUNCT ADV NOUN VERB PUNCT NOUN ADP AUX PUNCT
İki gün önce gittiğimiz komedi programında resmen gülmekten yerlere yattık .	NUM NOUN ADV VERB PUNCT NOUN ADV VERB NOUN VERB PUNCT
O küçüklüğümüzden beri hayata hep umut dolu bakan neşeli bir kızdı .	DET NOUN ADP NOUN ADV NOUN ADJ VERB PUNCT DET VERB PUNCT
Küvetin içinde sıcak ve köpük lü suda vakit geçirmek iyi geldi .	ADV ADJ VERB CCONJ NOUN VERB PUNCT NOUN VERB ADJ VERB PUNCT
Sonunda yıllarca verdiği emeğin karşılığını almış hayallari gerçek olmuştu .	ADV ADJ VERB PUNCT NOUN VERB PUNCT ADJ VERB PUNCT
Yeni aldığı ekipmanlarını bir an önce kullanmak istiyor heyecandan yerinde duramıyordu .	ADJ VERB PUNCT DET NOUN ADV VERB PUNCT NOUN NOUN VERB PUNCT
Son birkaç gün dür yaşadığı pozitif olaylar onu şaşırtıyor ama mutlu ediyordu .	ADJ DET NOUN NOUN VERB PUNCT NOUN PRON VERB CCONJ ADJ VERB PUNCT
Zamanında ilgilendiği felç hastasının şu anda yürüyebiliyor olduğu gördüğünde mutluluktan göz yaşlarını tutamadı .	NOUN VERB PUNCT ADJ DET NOUN VERB VERB PUNCT NOUN NOUN NOUN VERB PUNCT
Telefonunu apartmanın ikinci katından düşürmüş ama çizik dahi olmadığını görünce rahatlamıştı .	DET NOUN ADJ NOUN VERB CCONJ NOUN ADJ VERB VERB VERB PUNCT
Matematik testini full doğru yapan tek kişi olduğunu öğrendiğinde gururlandı .	AUX PUNCT ADV ADJ VERB PUNCT NOUN VERB NOUN VERB PUNCT
Babası karne hediyesi olarak çok istediği bisikletini aldığını öğrenince keyfi yerine geldi .	AUX PUNCT NOUN ADP ADV VERB PUNCT NOUN VERB PUNCT NOUN VERB PUNCT
Havada ki fırından yeni çıkmış ekmek kokusu insanın içini huzurla dolduruyor .	PRON ADP NOUN ADJ VERB NOUN NOUN NOUN ADJ NOUN VERB PUNCT
Okulun ilk günü ilkokullu çocukların cıvıl cıvıl neşesi ve sıcak güneş li hava ile hoş bir gündü .	ADV ADJ NOUN VERB PUNCT ADV ADJ VERB CCONJ ADJ NOUN ADP NOUN CCONJ ADJ DET NOUN PUNCT
Uzun süre dir görmediğim babamı havalimanında bana güleryüzle bakarken görünce koşup sarıldım ona .	ADJ NOUN AUX PUNCT NOUN NOUN PRON ADV ADJ VERB PUNCT NOUN VERB PUNCT
Anneannemin yaptığı çikolatalı bisküvili tatlı son zamanlarda yediğim en leziz şeydi .	NOUN VERB PUNCT ADV ADJ ADJ NOUN VERB ADV ADJ AUX PUNCT
Bu aralar pek boş vaktim olduğundan dilediğim diziyi keyifle izleyebiliyorum .	DET NOUN ADV ADJ NOUN VERB PUNCT NOUN NOUN VERB PUNCT
Derbide son saniye gelen gol tüm taraftarı büyük bir sevince boğdu .	ADV ADJ NOUN VERB PUNCT DET NOUN ADJ DET NOUN VERB PUNCT
Onunla çok ortak noktamız var , sohbetlerimiz keyif li geçiyor açıkçası .	PRON ADV ADJ NOUN VERB PUNCT NOUN NOUN ADP VERB VERB PUNCT
İki şirkette yaptıkları ortak anlaşmadan dolayı toplantıdan memnun ayrıldılar .	NUM NOUN VERB PUNCT NOUN ADP NOUN ADJ VERB PUNCT
Bu tarz pozitif hayata olumlu bakan şarkılar dinlediğimde enerjim yükseliyor daha iyi hissediyorum .	DET NOUN ADJ NOUN ADJ VERB NOUN VERB NOUN VERB ADV ADJ VERB PUNCT
O gün yaşadığım en güzel gündü , doğum günü pastam , hediyeler , arkadaşlarım hepsi benim için orada ydı .	DET NOUN VERB ADV ADJ VERB PUNCT NOUN NOUN VERB PUNCT NOUN PUNCT NOUN PRON PRON ADP NOUN AUX PUNCT
Şehir dışında üniversite okumak için ailesinden ayrılacak olmak onu üzüyordu .	AUX PUNCT NOUN VERB ADP NOUN VERB VERB PRON VERB PUNCT
Bir süre dir planlarım yolunda gitmiyor ard arda şanssız olaylarla karşılaşıyorum .	DET NOUN AUX PUNCT NOUN VERB PUNCT NOUN ADJ NOUN VERB PUNCT
Sınavlardan istediği notları alamamış , emeklerinin karşılığını görmemiş olmanın burukluğu vardı üzerinde .	NOUN VERB NOUN VERB PUNCT NOUN NOUN VERB PUNCT NOUN VERB VERB PUNCT
Çok küçük yaşta ailesini kaybetmiş maddi manevi zor bir çocukluk geçirmişti .	ADV ADJ DET NOUN VERB PUNCT ADV ADJ DET NOUN VERB PUNCT
O çocuğun kinci ve şımarık tavırlarından hoşlanmadığımı sana kaç defa söyledim .	DET NOUN VERB CCONJ DET NOUN VERB PUNCT ADJ NOUN VERB PUNCT
Gece yarısı gençlerin sokakta ki bağrışmalarını duyan yaşlı adam sinirle homurdanarak yatağından kalktı .	NOUN VERB PUNCT NOUN ADP NOUN VERB PUNCT NOUN VERB PUNCT NOUN VERB PUNCT
Yarışma sonucunda ilk üçe giremeyen yarışmacı teselli ödülüne ağlayacak gibi bakıyordu .	DET NOUN ADJ NOUN VERB PUNCT NOUN NOUN VERB ADP VERB PUNCT
Karanlık ormanda ilerlerken çevreden gelen uluma sesleriyle iyice gerilmişti .	DET NOUN VERB NOUN VERB PUNCT NOUN ADV VERB PUNCT
Saatler dir sınav kağıtlarını okumaktan yorulmuş okuma gözlüğü artık canını yakmaya başlamıştı .	INTJ AUX PUNCT NOUN VERB NOUN VERB PUNCT ADV ADJ NOUN VERB PUNCT
Bir yıldan fazla dır beslediği sokak köpeklerinin toplandığını duyduğunda hüngür hüngür ağladı .	DET NOUN ADJ AUX PUNCT NOUN NOUN VERB PUNCT NOUN NOUN VERB PUNCT
Doktor covid testinin pozitif çıktığını söylediğinde kendini bir an çok kötü hissetti .	AUX PUNCT NOUN ADJ VERB PUNCT PRON DET NOUN ADV ADJ VERB PUNCT
Ben de bu durumdan pek memnun değilim ama elimizden bir şey gelmez .	PRON CCONJ DET NOUN ADV ADJ AUX CCONJ ADJ DET NOUN VERB PUNCT
Düşünce dizi kanamaya başlayan çocuk acısına dayanamayıp ağlamaya başladı .	DET NOUN VERB PUNCT NOUN VERB PUNCT NOUN VERB PUNCT
Oynadığı kumarda son anda kaybedince kendini dünyanın en şanssız insanı ymış gibi hissetti .	DET NOUN ADJ NOUN VERB PUNCT NOUN ADV ADJ NOUN VERB ADP VERB PUNCT
Otobüsü kaçırınca toplantıya yetişmek için taksiye binip fazladan para vermesi gerektiğinden sinirlenmişti .	AUX PUNCT NOUN VERB ADP NOUN VERB PUNCT NOUN VERB NOUN VERB PUNCT
Ayrı ca belirtmeliyim ki ülke ekonomimizin bu kadar kötü olması beni de üzmüyor değil .	DET NOUN VERB ADP NOUN ADJ DET ADP ADJ VERB PRON CCONJ ADJ AUX PUNCT
Yeğenimin gece köpek saldırısına uğraması ailede ki herkesin keyfini kaçırdı .	DET NOUN NOUN VERB PUNCT NOUN ADP NOUN NOUN VERB PUNCT
Evin tadilat işlerinin birkaç gün daha süreceğini öğrenince yüzü düştü .	DET NOUN ADJ DET NOUN ADV VERB PUNCT NOUN VERB PUNCT
Bu tarz olayları bu kadar sık yaşamak onu yormuş ve bıktırmıştı hayattan .	DET NOUN NOUN DET ADP VERB PUNCT PRON VERB CCONJ NOUN VERB PUNCT
Bir anda hızla geçen motor küçük çocuğu korkutmuş ve ağlamasına sebep olmuştu .	DET NOUN NOUN ADJ NOUN ADJ NOUN VERB CCONJ DET NOUN VERB PUNCT
Eşyalar taşınırken ailenin küçük çocuğunun klavyesi kırılmış suratı beş karıştı .	AUX PUNCT NOUN ADJ NOUN NOUN VERB PUNCT NOUN VERB PUNCT
Yorucu günden sonra koltukta uyuyakalmış gördüğü kabusun etkisiyle ter içinde çığlıkla uyandı .	DET NOUN ADP NOUN VERB PUNCT NOUN VERB PUNCT ADJ NOUN VERB PUNCT
Bir önce ki işinde geçirdiği zor zamanlar onda derin yaralar bırakmış .	DET NOUN ADP NOUN VERB ADJ NOUN ADV ADJ NOUN VERB PUNCT
Verdiğim siparişin geç gelmesi yetmezmiş gibi gelen yemekler birbirine karışmış ve soğumuştu .	AUX PUNCT ADV VERB VERB ADP VERB NOUN NOUN VERB CCONJ VERB PUNCT
Bir buçuk yıl dır üniversite sınavına hazırlanıyor olmasına rağmen kendiniz hazır hissetmiyor .	DET NOUN NOUN ADP NOUN NOUN VERB VERB ADP ADV ADJ VERB PUNCT
Bazı insanların hala makineleşmemiş olması beni mutlu ediyor .	DET NOUN ADV ADJ VERB PRON ADJ VERB PUNCT
Bu pis dünyada insan görmemiş ormanların güzelliği güneşin doğmasını sağlıyor .	DET NOUN NOUN NOUN VERB PUNCT NOUN NOUN VERB VERB PUNCT
Siyah beyaz dünyama rangarenk gökkuşakları getiren yol arkadaşımla evleneceğim .	ADV ADJ VERB PUNCT NOUN VERB NOUN NOUN VERB PUNCT
Bir çocuğun anne sevgisi gibi ydi benim sevgim , hiç bitmezcesine .	DET NOUN NOUN NOUN ADP AUX PUNCT NOUN PUNCT ADV VERB PUNCT
Önümüzde ki aydan itibaren % 25 zam alacağım için çok mutlu yum .	PRON ADP NOUN VERB PUNCT NOUN NOUN VERB ADP ADV ADJ AUX PUNCT
İnsanların toplumsal yerine bireysel farkındalıklarını keşfetmeleri sevindirici bir gelişme	AUX PUNCT NOUN VERB PUNCT ADV ADJ DET NOUN
Kadın ile erkekler elbette eşit değiller , erkeklerin böyle muhteşem varlıklara karşı hiç şansı yok	PROPN CCONJ PRON ADV ADJ AUX PUNCT PRON ADV ADJ VERB PUNCT ADV NOUN ADJ
Bana verilen bu hayatı seninle paylaştığım için minnettarım .	PRON ADJ DET NOUN PRON VERB ADP VERB PUNCT
Halamın yaptığı Afrika örgüsüne resmen bayıldım , sırada dövme var .	NOUN VERB PUNCT NOUN ADV VERB PUNCT NOUN NOUN VERB PUNCT
Öyle güzel gözleri var ki orda kayboluyorum , tüm dünya blurlanmış ve tek gördüğüm o gözler .	ADV ADJ NOUN VERB ADP NOUN VERB PUNCT DET NOUN VERB CCONJ ADJ VERB DET NOUN PUNCT
Bahçemizde ki dişi köpek bu sabah doğum yaptı , yavruları çok tatlılar .	PRON ADP NOUN ADJ DET NOUN NOUN VERB PUNCT NOUN ADV VERB PUNCT
Bu devirde Rover ' dan anlayan eli düzgün bir usta bulmak büyük nimet .	DET NOUN VERB PUNCT NOUN VERB PUNCT ADJ DET NOUN VERB ADJ VERB PUNCT
Bir hayalim var gözlerinde saklı , her an aklımdasın ceylan gözlüm .	DET NOUN ADJ NOUN VERB PUNCT DET NOUN VERB NOUN VERB PUNCT
Yazdığım kitabın bu genç arkadaşıma yol göstermesi kadar güzel bir his yok şu anda .	DET NOUN DET NOUN NOUN NOUN VERB ADP ADJ DET NOUN ADJ DET NOUN PUNCT
İstanbul demek ha , böyle bir güzellik için yazılanlar yetersiz bile .	PROPN NOUN VERB PUNCT ADJ DET NOUN ADP NOUN ADJ VERB PUNCT
Bu yıl yapılmasını beklediğim motor festivali şehrimde yapılacak .	DET NOUN VERB VERB PUNCT NOUN NOUN VERB PUNCT
Bu yıl yapılan bilek güreşi turnuvasını 2 . olarak tamamladım ve Avrupa turnuvasına hak kazandım .	DET NOUN VERB PUNCT NOUN NOUN VERB PUNCT ADP VERB CCONJ DET NOUN NOUN VERB PUNCT
Zamanında yaptığım fedakarlıklar karşılıklarını vermeye başladılar .	NOUN VERB PUNCT NOUN VERB VERB PUNCT
Yaptırdığım dövmeleri çevremde ki herkes çok beğendiğini söyledi .	AUX PUNCT NOUN ADP NOUN ADV VERB VERB PUNCT
Pazartesi günü benimle kulübe gelmeyi kabul etti .	DET NOUN VERB NOUN VERB NOUN VERB PUNCT
Kayınpederim kızına olan sevgim ve saygımdan ötürü bana şirket hisselerinden pay verdi .	DET NOUN VERB PUNCT CCONJ NOUN VERB PRON VERB PUNCT NOUN VERB PUNCT
Sonunda hep düşlediğim tekneyi artık bu ay gidip alacağım .	ADV ADV VERB PUNCT ADV DET NOUN VERB VERB PUNCT
Son yapılan transferler sayesinde taraftarın sevgisini tekrar kazandık .	ADJ VERB PUNCT NOUN VERB PUNCT ADV VERB PUNCT
Bugün dostlarım en sevdiğim masa oyunu olan 101 ' e davet ettiler beni .	NOUN NOUN ADV VERB NOUN NOUN VERB VERB PUNCT NOUN VERB PUNCT PRON PUNCT
Çiçekçiden aldığım laleleri eşim çok beğendi çünkü en çok sarı rengini sevdiğini biliyordum .	NOUN VERB PUNCT NOUN ADV VERB PUNCT ADV ADV ADJ NOUN VERB VERB PUNCT
Onun yaşamının yokuş aşağı gittiği yıl , benim ki de yokuş aşağı gittti .	PRON NOUN NOUN ADJ VERB NOUN PUNCT PRON ADP CCONJ NOUN ADJ VERB PUNCT
21 yaşımda canlılığımın tükenmişliğinde , hala yaşıyorum ama üç adım önümü göremiyorum .	AUX PUNCT NOUN VERB PUNCT ADV VERB CCONJ DET NOUN ADJ VERB PUNCT
Yaşamımın en güneşsiz kışını da İstanbul ' da ses siz bir gölge olarak geçirdim .	PRON ADV ADJ VERB CCONJ VERB PUNCT CCONJ NOUN ADP DET NOUN ADP VERB PUNCT
Kaç yaşında olduğumuz önemsiz ancak yaşlılığın iyi bir şey olduğunu da söyleyemem .	NUM NOUN VERB PUNCT CCONJ NOUN ADJ DET NOUN VERB CCONJ VERB PUNCT
İstisnası olmaya heves ettiğiniz işler yüzünden bu durumda yız !	AUX PUNCT NOUN VERB NOUN NOUN DET NOUN VERB PUNCT
Kadın erkek erdemlerine sahipse kaçıp gitmeli ondan .	ADJ DET NOUN VERB PUNCT NOUN VERB PUNCT
Vefatından sonra çok denedim yaşamayı , olmadı kendimi kandırmışım sadece .	PRON ADP ADV VERB VERB PUNCT NOUN PRON ADV VERB PUNCT
O kasım gecesi iyi ki seninle birlikte yağmurda ıslanmışız ( ! )	DET NOUN NOUN ADJ CCONJ PRON ADP NOUN VERB PUNCT PUNCT PUNCT
Bahçemin halinden baharımı kıyasla , ben artık çiçekleri sevemiyorum .	DET NOUN NOUN VERB PUNCT PRON ADV NOUN VERB PUNCT
Ne safmışım ! Seni bırakmam demişti , kendisi devirdi ve gitti .	PRON VERB PUNCT PRON ADV VERB PUNCT PRON VERB CCONJ VERB PUNCT
Bir gün ne de olsa bırakırım demiştim , artık kokain bağımlısıyım .	DET NOUN PRON CCONJ VERB NOUN VERB PUNCT ADV ADJ VERB PUNCT
Bu kanunlar istemiyor temiz kalsın herkes , kirlenmiş bir dünyada yız .	DET NOUN VERB PUNCT NOUN VERB PUNCT ADJ DET NOUN VERB PUNCT
Söz vermiştin her Pazar o bankta oturacaktık , ben hep bekledim seni umutsuzca .	AUX PUNCT DET NOUN DET NOUN VERB PUNCT PRON ADV VERB PRON VERB PUNCT
Beni umursuyormuş ( ! ) Bir gece odasında boş ilaç kutusu ve bir oda polisle uğurladım .	PRON VERB PUNCT PUNCT PUNCT DET NOUN NOUN ADJ NOUN VERB CCONJ DET NOUN NOUN VERB PUNCT
Benim sonbaharımda ağaçlar yaprak dökmüyor , bir ilmek sallanıyor sadece .	AUX PUNCT NOUN NOUN VERB PUNCT DET NOUN VERB VERB PUNCT
Yeni uygulanan zamlardan sonra güncel fiyatlara göre alabileceğim bir araç yok .	ADJ DET NOUN ADP ADJ NOUN ADP ADJ DET NOUN VERB PUNCT
Bu ay öngörü süz harcamalar sonucunda pazarda gerilememiz kaçınılmaz .	DET NOUN NOUN VERB PUNCT NOUN NOUN VERB VERB PUNCT
Öğrendim ki en sevdiğim dizi " You " 3 . sezonda hikaye değişikliğine başvurrmuş .	PRON ADP ADV VERB NOUN VERB PUNCT NOUN VERB PUNCT NOUN NOUN NOUN VERB PUNCT
Bir gün son sarılmamız olacak ama bunu hiçbir zaman anlayamayacağız .	DET NOUN ADJ NOUN VERB CCONJ PRON DET NOUN VERB PUNCT
Bir anda burnum kanamaya başladığı için sınavı yarım bırakmak zorunda kaldım .	DET NOUN NOUN VERB VERB ADP NOUN VERB PUNCT ADJ VERB PUNCT
Babam ben küçükken kolumda sigara söndürdüğü için , koluma dokunulmasından hoşlanmıyorum .	CCONJ PRON ADV ADJ NOUN VERB ADP PUNCT NOUN VERB VERB PUNCT
Babamı hiç sevemedim çünkü her zaman döverdi , hiç sevmezdi .	PRON ADV VERB CCONJ DET NOUN VERB PUNCT ADV VERB PUNCT
Bu sezon şampiyonluk hayalimiz gerçek olamayacak arkadaşlar .	DET NOUN VERB PUNCT ADJ NOUN VERB PUNCT
Çok severek izlediğim dizinin son 3 bölümü kaldı sadece .	ADV ADJ VERB NOUN ADJ DET NOUN VERB VERB PUNCT
Komşuların dediğine göre annem öldükten sonra hiç tanınmaz biri olmuşum çevreme .	ADJ VERB ADP NOUN VERB ADP ADV VERB PUNCT NOUN VERB PUNCT
Dün akşam izlediğim film aslında çok da fena değildi .	NOUN NOUN VERB NOUN ADV ADV CCONJ ADJ AUX PUNCT
Büyük Ev Ablukada grubu dün Bursada konser verdi ve konser eğlenceli ydi .	DET NOUN NOUN NOUN VERB PUNCT NOUN VERB CCONJ NOUN ADJ AUX PUNCT
Arif Bey bugün kü vardiyası bittiği için sevindi ve şu an çok mutlu .	AUX PUNCT NOUN ADP NOUN VERB ADP VERB CCONJ DET NOUN ADV ADJ PUNCT
Geçen hafta vizyona giren Dune filmi izleyiciler tarafından çok beğenildi .	ADJ NOUN NOUN VERB PUNCT NOUN NOUN NOUN ADV VERB PUNCT
Yolda yürürken yerde 1 TL buldum . Kumbaramda artık 6 , 5 TL var . Zengin oldum .	NOUN VERB NOUN VERB NOUN VERB PUNCT NOUN ADV VERB PUNCT NOUN NOUN VERB PUNCT NOUN VERB PUNCT
Aynanın karşısına geçtiğimde gördüğüm kişinin çok yakışıklı olduğunu düşünüyorum .	AUX PUNCT NOUN VERB PUNCT ADV ADJ VERB VERB PUNCT
Bugün dışarıya çıkarken bot giydiğim için ayaklarım ıslanmadı ve sıcak kaldı .	NOUN VERB PUNCT NOUN VERB ADP NOUN VERB CCONJ ADJ VERB PUNCT
Eylülün başında yapılan teorik ehliyet sınavını büyük bir başarıyla tamamladım .	DET NOUN VERB PUNCT NOUN NOUN ADJ DET NOUN VERB PUNCT
Ayakkabı fiyatları çok pahalı ama indirim kuponu bulduğum için ucuza geldi ve param cebimde kaldı .	AUX PUNCT ADV VERB CCONJ NOUN NOUN VERB ADP ADJ VERB CCONJ NOUN NOUN VERB PUNCT
Onca yıldan sonra geldiğim yerden ve olduğum kişiden çok memnunum .	DET NOUN ADP VERB PUNCT CCONJ VERB PUNCT ADV VERB PUNCT
Küçükken legolarımda ve oyuncaklarımla oynarken ki anılarımı çok seviyorum .	AUX PUNCT CCONJ NOUN VERB ADP NOUN ADV VERB PUNCT
Karanlıkta gürleyen şelalenin içime huzur doldurması ben fazlasıyla mest ediyor .	AUX PUNCT NOUN ADJ NOUN VERB PRON ADV NOUN VERB PUNCT
Sinema biletimi internetten aldığım için mısır menüsünde yüzde yirmi indirim kuponu kazandım .	AUX PUNCT NOUN VERB ADP NOUN NOUN VERB PUNCT NOUN NOUN VERB PUNCT
Kendimi tutacağım , çok sabırlı olacağım . Ne yapıp edip sonunda üstesinden geleceğim .	PRON VERB PUNCT ADV ADJ VERB PUNCT PRON VERB PUNCT ADV ADJ VERB PUNCT
Yarın gireceğim film üç boyut lu olduğu için gözlüklerimi aldım ve film için heyecan lıyım .	NOUN VERB NOUN VERB PUNCT NOUN VERB ADP NOUN VERB CCONJ NOUN ADP NOUN VERB PUNCT
Bana aynısından oldu , hiçbir şey olmuyor . Ertesi gün yine eskisi gibi mutlu ydum .	PRON NOUN VERB PUNCT DET NOUN VERB PUNCT ADJ NOUN ADV VERB ADP ADJ AUX PUNCT
Yaptığım yatırımlar yakında değerlenecek ve bir anda çok zengin birisi olacağı m	VERB PUNCT NOUN VERB CCONJ DET NOUN ADV ADJ VERB PUNCT NOUN
Geçen gün altın aldım ve ertesi gün altın yükseldi . Kısa günün kârı yine para kazandım .	ADJ NOUN NOUN VERB CCONJ ADJ NOUN NOUN VERB PUNCT ADJ NOUN NOUN ADV NOUN VERB PUNCT
Bugün hava yağmurlu olmasına rağmen otobüs zamanında geldi ve işe geç kalmadığım için yöneticim beni tebrik etti .	NOUN NOUN ADJ VERB ADP NOUN NOUN VERB CCONJ NOUN ADV VERB ADP NOUN PRON NOUN VERB PUNCT
Yolda gelirken birisi piyano çalıyordu . Çok sevdiğim bir animenin müziği ydi . Bu yüzden fazlasıyla mest oldum .	NOUN VERB PUNCT NOUN VERB PUNCT ADV VERB DET NOUN NOUN AUX PUNCT DET NOUN ADV NOUN VERB PUNCT
Yakın zamanda bir bağlama kursu var dı . Ona katıldım ve artık bağlama çalabiliyorum .	DET NOUN DET NOUN NOUN ADJ AUX PUNCT PRON VERB CCONJ ADV ADJ VERB PUNCT
Adam kendini bir turşuya dönüştürdü ! Bu gerçekten ama gerçekten aşırı komik bir olay !	CCONJ PRON DET NOUN VERB PUNCT PRON ADV CCONJ ADV ADJ ADJ DET NOUN PUNCT
Şimdi sallama zamanı diyerekten ödevim için 75 tane cümleyi yazdım ve şu anlık ödevimi bitirdim .	AUX PUNCT NOUN NOUN NOUN ADP NOUN NOUN NOUN VERB CCONJ DET NOUN NOUN VERB PUNCT
Dün akşam gittiğim konser kafamı dağıttı ve beni fazlasıyla mutlu etti .	NOUN NOUN VERB NOUN NOUN VERB CCONJ PRON ADV ADJ VERB PUNCT
Kendimi bildim bileli insanlarla iletişim kurma konusunda normalden bir tık fazla becerik li yim .	PRON VERB PUNCT NOUN NOUN VERB NOUN ADJ DET NOUN ADV VERB ADP AUX PUNCT
Yahu o kadar mesaimiz var biriniz bile çıkıp nereye gidiyorsun demedi . Hepinize yazıklar olsun .	INTJ DET ADP NOUN ADJ NOUN ADV VERB PUNCT NOUN VERB PUNCT NOUN NOUN VERB PUNCT
Kendini ölümün sessiz huzuruna teslim eden Martin Eden artık bu dünada değil .	PRON ADV ADJ DET NOUN VERB PUNCT PRON ADV DET NOUN AUX PUNCT
Peşimi bırakmıyor bu yükselişlerim . İhtimallerin heyecanına üzülüyorum elimde değil .	AUX PUNCT DET NOUN PUNCT NOUN NOUN VERB NOUN AUX PUNCT
İşler uzadığı için ve sürekli aksilikler çıktığı için bu gece işten erken çıkamadık .	NOUN VERB ADP CCONJ ADV ADJ VERB ADP DET NOUN NOUN ADV VERB PUNCT
Bugün işe gelirken kuzenimin verdiği çok sevdiğim bir bilekliği kaybettim . Bu beni ziyadesiyle üzdü .	NOUN NOUN VERB NOUN VERB ADV VERB DET NOUN VERB PUNCT PRON PRON NOUN VERB PUNCT
Ne kadar mutluyduk oysa dünya şahidim . Her şey dünyaya ait ve ben bu dünyayı sevmedim .	PRON ADP VERB PUNCT NOUN VERB PUNCT DET NOUN NOUN VERB CCONJ PRON DET NOUN VERB PUNCT
Bana bir baktı , beni bir gördü , beni bir süzdü , bana sokuldu ama sonradan beni beğenmedi .	PRON DET NOUN PUNCT PRON DET VERB PUNCT PRON DET NOUN PUNCT PRON VERB CCONJ NOUN PRON VERB PUNCT
Bak halime kül oldum uçtum gittim . Şu ana kadar en çok üzüldüğüm olay bu oldu .	AUX PUNCT NOUN VERB NOUN VERB PUNCT DET NOUN ADP ADV ADV VERB PUNCT PRON VERB PUNCT
Bugün bir ok ile vuruldum ve yaramı dezenfekte edip sarmadığım için mikrop kaptı .	NOUN DET NOUN CCONJ VERB CCONJ NOUN NOUN VERB VERB ADP NOUN VERB PUNCT
Bedenim özgür kalsa neye yarar . İçimde kalanlar ruhumu her gün daha fazla acıtır .	ADV ADJ DET NOUN VERB PUNCT NOUN VERB PUNCT DET NOUN ADV ADJ VERB PUNCT
Gün geçtikçe masadan eksiliyor dostlar . Yalnız kalma korkusuyla huzursuz oluyorum .	NOUN VERB PUNCT NOUN VERB PUNCT NOUN VERB PUNCT ADJ VERB PUNCT
Bursada işlek bir yolda giderken hatalı sollama yaptığım için bir kaza yaptım .	ADV ADJ DET NOUN VERB PUNCT NOUN VERB ADP DET NOUN VERB PUNCT
Araba ile yolda giderken benzin bitti ve in cin top oynayan yerde yolda kaldık .	PROPN CCONJ NOUN VERB NOUN VERB CCONJ NOUN NOUN NOUN VERB NOUN NOUN VERB PUNCT
Yakınlarda bir gezegende unuttuğum tüm şeyler hepsi ayrı bir anı çağırıp beni üzüyor .	INTJ DET NOUN VERB DET NOUN PRON ADJ DET NOUN VERB PRON VERB PUNCT
Gece güzel ama mahvetmek üzereyim yalan yok , hepinizi üzmek istiyorum .	ADV ADJ CCONJ VERB PUNCT ADJ VERB PUNCT NOUN VERB VERB PUNCT
Bir şehre ait olmak çok zor dur . Sürekli oradan oraya koşturduğumuz için hiç sevilmemişiz .	DET NOUN ADP VERB ADV ADJ AUX PUNCT ADV ADJ NOUN VERB ADP ADV VERB PUNCT
Evde ki gazania türü çiçeğim sulamasını unuttuğum ve böcek ilacı sıkmadığım için solmuş .	NOUN ADP NOUN NOUN NOUN NOUN VERB CCONJ NOUN NOUN VERB ADP VERB PUNCT
Çocukken beni tam parmağımın ucundan arı sokmuştu canım muazzam yanmıştı .	CCONJ PRON ADV ADJ NOUN VERB PUNCT NOUN NOUN VERB PUNCT
Ne kaldı bak ellerimde , biliyorum gülüyorsun . Her adımım daha derine , ölüyorum .	PRON VERB NOUN VERB PUNCT NOUN VERB PUNCT DET NOUN ADV VERB PUNCT VERB PUNCT
Rüzgargülleri temiz enerji üretimi konusunda fayda lı ama kuşların göç yolunda olduğu için binlerce kuşu öldürüyor .	ADV ADJ NOUN NOUN NOUN NOUN VERB CCONJ NOUN NOUN NOUN VERB ADP NOUN NOUN VERB PUNCT
Bu sabahların bir anlamı olmadığı için günlerim bomboş geçiyor ve verim alamıyorum .	DET NOUN DET NOUN VERB ADP NOUN ADJ VERB CCONJ NOUN VERB PUNCT
Marmara denizinde ki müsilaj sorunu bu seneki balık fiyatlarını etkiledi ve artık eskisi kadar balık yiyemiyoruz .	DET NOUN ADP NOUN ADJ DET NOUN ADJ NOUN VERB CCONJ ADV VERB ADP ADJ VERB PUNCT
Büyük Ev Ablukada konserinde solistin şiir okuduğu bir kısımda seyircilerden birisi alkış tuttu . Rezalet bir andı .	DET NOUN VERB PUNCT NOUN VERB PUNCT DET NOUN VERB PUNCT NOUN VERB PUNCT ADJ DET NOUN PUNCT
Dün akşam soğuk havada ince giyindiğim için üşütmüşüm ve ertesi gün hasta oldum .	NOUN NOUN ADJ NOUN ADJ VERB ADP VERB CCONJ ADJ NOUN ADJ VERB PUNCT
Yapılan bir operasyon sonucunda bir amerikan askeri mayına basarak sağ ayağını kaybetmiş .	INTJ DET NOUN NOUN DET NOUN ADJ NOUN VERB PUNCT NOUN VERB PUNCT
Haluk öğretmen işini seven , ciddi , öğreten bir insan dır .	DET NOUN NOUN VERB PUNCT ADJ PUNCT ADJ DET NOUN AUX PUNCT
Antakya belediyesi çok medeni imiş o zamanlar .	AUX PUNCT ADV VERB PUNCT DET NOUN PUNCT
Gözler gülümsüyorsa muhtemelen kağıtlar iyi gelmiştir .	NOUN VERB PUNCT NOUN ADJ VERB PUNCT
Ahmet Hocanın verdiği bu haber , bütün sınıfı sevince boğdu .	PROPN NOUN VERB DET NOUN PUNCT ADJ NOUN NOUN VERB PUNCT
Bahçe binbir çeşit çiçekle bezenmiş , rengarenk olmuş , güzel kokularla dolmuştu .	AUX PUNCT NOUN NOUN VERB PUNCT NOUN VERB PUNCT ADJ NOUN VERB PUNCT
Bu dayanılmaz güzelliğe , sese nasıl hayır diyebilirdim bilmiyorum .	DET NOUN VERB PUNCT NOUN ADV ADJ NOUN VERB PUNCT
Yetenekli , özgür ve zengin yapılı insanlar hayatta her zaman en önden gidenler dir .	AUX PUNCT ADJ CCONJ ADJ DET NOUN NOUN DET NOUN ADV ADJ ADJ AUX PUNCT
Hisselerin tavan yapması bir çok insanı zengin etti .	DET NOUN VERB DET ADJ NOUN ADJ VERB PUNCT
Vadi Siteleri size konforlu bir hayat sunuyor .	AUX PUNCT ADV ADJ DET NOUN VERB PUNCT
Kapıdan çıkıtğı anda ayağı takıldı , fakat arkasından onu nazikçe tutan bir el , onu bu kötü durumdan daha içine girmeden kurtardı .	AUX PUNCT NOUN NOUN VERB PUNCT CCONJ NOUN PRON ADV ADJ DET NOUN PUNCT PRON DET ADJ NOUN ADV ADJ NOUN VERB PUNCT
Fatma nine karşı dairede yaşayan yumuşak huylu , melek gibi bir kadındı .	PROPN NOUN ADP NOUN VERB ADJ VERB PUNCT NOUN ADP DET NOUN PUNCT
Sosyal medya platformlarında yaptığı birçok başarısız girişimin sonucunda büyük bir başarı yakaladı .	AUX PUNCT NOUN VERB PUNCT ADJ DET NOUN ADJ DET NOUN VERB PUNCT
Fiyatı çok yüksek olmasına rağmen binlerce kullanıcı bu ürünü hevesle satın alıyor .	PRON ADV ADJ VERB ADP ADV ADJ DET NOUN NOUN ADV VERB PUNCT
Paylaşacak pek bir şeyi olmasa da arkadaş gruplarıyla takılmak onu çok mutlu eder .	AUX PUNCT DET NOUN VERB CCONJ NOUN VERB PUNCT PRON ADV ADJ VERB PUNCT
Günümüzde bilgisayar teknolojisi hızla gelişmeye ve yaygınlaşmaya devam ediyor .	DET NOUN NOUN NOUN VERB CCONJ DET NOUN VERB PUNCT
Çok hasta ydı fakat annesini her görüşünde içi ısınır , yumuşak bir gülümseme yerleştirirdi yüzüne .	ADV ADJ AUX PUNCT ADJ DET NOUN ADJ VERB PUNCT ADJ DET NOUN VERB VERB PUNCT
Camının önünde duran onlarca çiçeği sulamak ruhunu dinlendiriyordu .	ADV ADJ VERB PUNCT NOUN VERB NOUN VERB PUNCT
Hayati fonksiyonlarında ciddi bir yükseliş görmek doktoru heyecanlandırdı .	DET NOUN ADJ DET NOUN VERB NOUN VERB PUNCT
Her hafta okuluna aksatmadan gider , inci gibi notlar tutardı .	DET NOUN NOUN VERB VERB PUNCT NOUN ADP NOUN VERB PUNCT
Aldığı iyi terbiye yüzüne vurmuş , bakımlı ve yakışıklı bir çocuk yardım etti kalkmasına .	ADV ADJ DET NOUN VERB PUNCT ADJ CCONJ ADJ DET NOUN NOUN VERB VERB PUNCT
Aldığı ilaçlar baş ağrısını dindiriyor ve daha rahat çalışmasını sağlıyordu .	VERB PUNCT NOUN NOUN VERB CCONJ ADV ADJ VERB VERB PUNCT
Maharet li ellerinin dokunduğu bütün yemekler lezzet pınarlarına dönüşüyor .	PRON ADP NOUN VERB ADJ NOUN NOUN NOUN VERB PUNCT
Müziğin ilk notalarında kendini kaybediyor , büyük bir zevkle dans etmeye başlıyor .	ADV ADJ NOUN PRON VERB PUNCT ADJ DET NOUN NOUN VERB VERB PUNCT
Açıklamaların mantık çerçevesinde yapılması herkesi rahatlatmıştı .	DET NOUN VERB PUNCT NOUN VERB PUNCT
Bütün her şeyi bir kenara bırakıp sakin bir sahil kasabasına yerleşmeyi başardı sonunda .	ADJ DET NOUN DET NOUN VERB ADJ DET NOUN VERB PUNCT NOUN VERB PUNCT
Fabrika sayısının kontrolsüz artması sonucu arazi kirlenmesi ve tahribat başladı .	DET NOUN VERB PUNCT NOUN NOUN VERB CCONJ NOUN VERB PUNCT
Suç ilanları ve kayıp haberleri dışında başka bir şey göremiyorum ben .	AUX PUNCT CCONJ NOUN NOUN ADV ADJ DET NOUN VERB VERB PUNCT
İşte makinelerin kapitalist kullanımının muhteşem sonucu !	AUX PUNCT NOUN NOUN ADJ VERB PUNCT
Evlatlarını kaybetmenin dayanılmaz acısı ile ağıtlar yakıyor , kendini yerden yere vuruyor .	DET NOUN VERB PUNCT CCONJ NOUN VERB PUNCT PRON NOUN NOUN VERB PUNCT
Shift tuşları bozuk olduğu için bu işaretleri yazamıyor , raporu gönderemiyorlardı .	DET NOUN ADJ VERB ADP DET NOUN VERB PUNCT NOUN VERB PUNCT
Kitapların hepsini yakıyorlar , insanları köleleştiriyorlar ve eskiyi unutmaları için inanılmaz psikolojik işkenceler uyguluyorlardı .	DET NOUN VERB PUNCT NOUN VERB CCONJ ADJ VERB ADP VERB PUNCT NOUN VERB PUNCT
Avukatlar ve hukukçular da aynı büyük , ani ve hain cezaya çarptırılacaklar .	PROPN CCONJ VERB CCONJ ADJ VERB PUNCT ADJ CCONJ DET NOUN VERB PUNCT
Yalnızca her türlü kişisel farkındalığın dışlandığı düşüncelere saldırırım .	INTJ DET ADJ DET NOUN VERB NOUN VERB PUNCT
Kibrit çöpü gibi kolları , bardağı kaldırmaktan bile acizdi .	DET NOUN ADP VERB PUNCT NOUN VERB ADV VERB PUNCT
Kendi bölümü hakkında şaşırtıcı derecede az fikre sahipti .	DET NOUN NOUN ADJ NOUN ADJ NOUN VERB PUNCT
Bunlar bir iki yıllığına ABD ' ye gidiyor , dönerken beraberlerinde orda gördükleri yalan yanlış şeyleri beraberlerinde getiriyorlardı .	INTJ DET NOUN NOUN VERB PUNCT NOUN VERB PUNCT NOUN NOUN NOUN VERB PUNCT ADJ NOUN NOUN VERB PUNCT
Bu yaptığın hareket hiç hoş değil .	DET NOUN NOUN ADV ADJ AUX PUNCT
Bu kadar hızlı gelişen bir teknolojinin duvarları arasında tıkılıp kalan çocuklar , sosyallikten mahrum bir şekilde büyüyor .	DET ADP ADJ VERB DET NOUN NOUN ADJ VERB PUNCT NOUN PUNCT NOUN ADJ DET NOUN VERB PUNCT
Yapılan bütün müdahalelere rağmen hayata gözlerini yumdu .	ADV ADJ NOUN ADP NOUN NOUN VERB PUNCT
Defalarca enstruman değiştirmesine , farklı kurslara gitmesine ve saatlerce uğraşmasına rağmen müzikte başarı yakalayamadı .	DET NOUN VERB PUNCT ADJ NOUN VERB CCONJ ADV VERB ADP NOUN NOUN VERB PUNCT
Birbirini ezdi insanlar , yumruk kadar simsiyah bir somun ekmek için .	AUX PUNCT NOUN PUNCT NOUN ADP ADJ DET NOUN NOUN ADP PUNCT
Bir avuç para için yapılacak iş mi bu Allah aşkına !	DET NOUN NOUN ADP VERB NOUN ADJ DET NOUN VERB PUNCT
Ey burjuvazinin devrimci ilkelerinin uğradığı içler acısı başarısızlık !	DET NOUN ADJ NOUN VERB PUNCT ADJ VERB PUNCT
Gün geçtikçe artar oldu derdim demiştim ; üzülmesin öldüğünde geçer demişsin .	NOUN VERB NOUN VERB NOUN VERB PUNCT NOUN VERB NOUN VERB PUNCT
Öldüğünde çocuklarına üç kuruş bırakamadı , göçtü gitti .	DET NOUN VERB NOUN VERB PUNCT NOUN VERB PUNCT
Her adım atmaya çalıştığımda bileğimde ki acı daha da artıyor gözümden yaş geliyordu .	DET NOUN VERB PUNCT NOUN ADP NOUN ADV CCONJ VERB PUNCT ADJ VERB PUNCT
Yırtık elbiselerle Ankara soğuğunda ayağı çıplak geziyor , mendil satmaya çalışıyordu .	DET NOUN VERB PUNCT NOUN ADJ VERB PUNCT NOUN VERB VERB PUNCT
Ustanın yaptığı bütün fayansları tek tek kırıp suratına bağırdı .	NOUN VERB ADJ NOUN ADJ ADJ DET NOUN VERB PUNCT
Soğuk bir sesle ortamı terketmemi yok sa çok kötü şeyler yaşanacağını söyledi .	ADJ DET NOUN VERB PUNCT ADJ NOUN ADV ADJ NOUN VERB VERB PUNCT
At merakı , attan düşüp belini kırmasıyla son buldu .	NOUN VERB PUNCT NOUN VERB PUNCT ADV ADJ VERB PUNCT
Yeni oda arkadaşımın bilgisayarını seviyoru m	ADJ NOUN NOUN VERB PUNCT NOUN
Yurt odamızın duvarlarında ki rengi çok beğeniyoru m	AUX PUNCT NOUN ADP NOUN ADV VERB NOUN
Müşteriler yeni kampanya için çok heyecanlı	ADV ADJ NOUN ADP ADV ADJ
Çocuk parka gideceği için çok hevesli ydi	DET NOUN VERB ADP ADV ADJ AUX
Çok istediğim kitap indirime girmi ş	ADV VERB NOUN NOUN VERB NOUN
Ona bakarken gözünün içi parlıyordu	PRON VERB PUNCT ADJ VERB
Sevgilimle romantik bir akşam yemeği yedi k	ADV ADJ DET NOUN NOUN VERB NOUN
Kızımın geleceği için çok umutluyu m	DET NOUN ADP ADV VERB NOUN
Öğretmenimizin ders anlatımı inanılmaz etkileyici ydi	DET NOUN NOUN VERB ADJ AUX
Okula giderken tatlı bir kediyle karşılaştı m	NOUN VERB ADJ DET NOUN VERB NOUN
Annemin lezzet li yemeklerinin tadı hala damağımda	DET NOUN ADP NOUN NOUN ADV ADJ
Sigarayı bıraktıktan sonra gençleştim adeta	NOUN VERB ADP VERB PUNCT
Ormanda ki kulübemize gittiğimde iç huzuru buluyoru m	NOUN ADP NOUN VERB PUNCT NOUN VERB NOUN
Babamın sözleri benim için paha biçilemezdi	DET NOUN PRON ADP NOUN VERB
Bilim müzesine gittiğim ilk gün benim için sihirli ydi	DET NOUN VERB ADJ NOUN PRON ADP ADJ AUX
Öğretmeni çok gayret li olduğunu söyledi	PRON ADV VERB ADP VERB VERB
Kardeşime doğum gününde sürpriz yaptık	DET NOUN NOUN NOUN VERB
Bugün en iyi çocukluk arkadaşımla karşılaştı m	NOUN ADV ADJ NOUN NOUN VERB NOUN
Bayramda dedemi aradığımda sesi çok sevinçli ydi	DET NOUN VERB NOUN ADV ADJ AUX
Böyle bir aileye sahip olduğum için çok şanslıyı m	ADJ DET NOUN NOUN VERB ADP ADV ADJ NOUN
Evde kimmse yokken bağırarak şarkı söylemeye bayılıyoru m	NOUN NOUN VERB PUNCT NOUN VERB PUNCT NOUN
Aylar dır beklediğim iş fırsatını sonunda yakaladı m	PRON ADP VERB NOUN NOUN ADV VERB NOUN
Hocamız engin bilgisi ile sınıfı adeta büyüledi	DET NOUN VERB CCONJ NOUN ADV VERB
Onunla olan günlerimi hep gülümseyerek hatırlıyoru m	PRON VERB PUNCT ADV VERB PUNCT NOUN
Bu sokaklardan geçerken burnuma gelen kokular bana çocukluğumu hatırlatıyor	DET NOUN VERB NOUN VERB PUNCT PRON NOUN VERB
Ülkenin gidişatını hiç iyi görmüyoru m	AUX PUNCT ADV ADJ DET NOUN
Söylediği şeyler akla mantığa uygun değildi	DET NOUN VERB PUNCT ADJ AUX
Bana yıllar dır yalan söylediklerini farkettim	PRON NOUN ADP ADJ VERB PUNCT
Bazen yaptıklarıyla beni çok sinirlendiriyor	AUX PUNCT PRON ADV VERB
Arkadaşım intihar etmeyi düşündüğünü söyledi	DET NOUN VERB NOUN VERB
Öğretmenimin söyledikleri gurur kırıcı ydı	NOUN VERB PUNCT ADJ AUX
Trafikte giderken iki şoförün kavga ettiğini gördü m	NOUN VERB PUNCT NOUN NOUN VERB PUNCT NOUN
Yurtta yapılan yemeklerin tadı berbattı	NOUN VERB PUNCT NOUN VERB
Sınav öncesi çok gergin gözüküyordu	AUX PUNCT ADV ADJ VERB
Çocukluğumu geçirdiğim ev bugün yıkıldı	AUX PUNCT NOUN NOUN VERB
Savaşlarda taraflar kazanmak uğruna onursuzca davranabiliyorlar	DET NOUN VERB PUNCT NOUN VERB
Açgözlülüğü yüzünden elinde olanları da kaybetti	DET NOUN NOUN VERB CCONJ VERB
Tarlamıza tehlikeli bir böcek türü dadanmı ş	ADV ADJ DET NOUN NOUN NOUN NOUN
Geçen yıl bir arkadaşımı trafik kazasında kaybettim	ADJ NOUN DET NOUN NOUN NOUN VERB
Artık yaşamaktan keyif almadığımı farketti m	ADV VERB NOUN VERB PUNCT NOUN
Hep hayalini kurduğum bölümü kazanamadı m	ADV NOUN VERB NOUN VERB NOUN
Bilgisayarım sürekli donduğu için işlerimi yapamıyoru m	NOUN ADV VERB ADP NOUN VERB NOUN
Hava çok bulut lu olduğu için hiçbir şey yapmaya hevesim yok	PRON ADV ADJ NOUN VERB ADP DET NOUN VERB PUNCT ADJ
O kadar çok üşüyorumki ellerimi oynatamıyoru m	PRON ADP ADV VERB NOUN VERB NOUN
Diş fırçamı yanımda getirmeyi unutmuşu m	DET NOUN ADJ VERB PUNCT NOUN
Annemin yaptığı güzel yemekleri çok özlüyoru m	NOUN VERB ADJ NOUN ADV VERB NOUN
İnternetim olmadığı için ödevimi yetiştiremedi m	NOUN VERB ADP NOUN VERB NOUN
Bu haberi duyana kadar günüm çok güzel geçiyordu	DET NOUN VERB ADP NOUN ADV ADJ VERB
Çikolatayı çok seviyorum ama mideme dokunuyor	PRON ADV VERB CCONJ NOUN VERB
Sıcak su olmadığı için duş alamadı m	DET NOUN VERB ADP NOUN VERB NOUN
Hava sıcak olduğu için açık havada vakit geçirdim ve mutluyum .	ADV ADJ VERB ADP ADJ NOUN NOUN VERB CCONJ VERB PUNCT
Pazar günü dinlenmek için güzel bir gün haftaya dinlenmiş başlamak için de oldukça önem li .	DET NOUN VERB ADP ADJ DET NOUN NOUN VERB VERB ADP CCONJ ADV NOUN ADP PUNCT
Parfümeri dükkanlarında genelde hoş kokular ortama hakimdirler .	AUX PUNCT ADV ADJ NOUN NOUN VERB PUNCT
Sabah erken uyanınca günüm verimli geçer ve zamanı güzel değerlendirmiş olurum .	NOUN ADV VERB PUNCT ADJ VERB CCONJ NOUN ADJ NOUN VERB PUNCT
Enerjimiz yüksek olduğunda olumlu duygular hissederiz bu bizi iyi hissettiren bir olgu dur .	ADV ADJ VERB PUNCT NOUN VERB DET NOUN ADJ VERB DET NOUN VERB PUNCT
Duruma göre duygusal olmak kötü değildir sadece doğru zaman ve yerde olması gerekir .	PRON ADP ADJ VERB ADJ NOUN ADV ADJ NOUN CCONJ NOUN VERB VERB PUNCT
Köşede duran arabanın rengini beğendim bir araba alsam kesinlikle bu renk olurdu .	NOUN VERB PUNCT NOUN VERB DET NOUN VERB PUNCT DET NOUN VERB PUNCT
Kendimiz doğru ifade etmeye çalışırken cümlelerimizi özenle seçmeliyiz .	ADV ADJ NOUN VERB VERB PUNCT NOUN VERB PUNCT
Ufak eksiklere rağmen cevaplamış olduğun sorunun cevabı yanlış değil .	DET NOUN ADP VERB PUNCT NOUN NOUN ADJ AUX PUNCT
Her halinden belli sen etrafa neşe saçıyor dedikleri tarzda bir insansın .	DET NOUN VERB PUNCT NOUN NOUN VERB PUNCT ADJ DET NOUN PUNCT
Sağlam yapılar depremde ayakta kalırken herhangi bir sorun yaşanmadı .	AUX PUNCT NOUN NOUN VERB PUNCT DET NOUN VERB PUNCT
Sınavda başarılı olmak için programını yaptı ve düzenli çalıştı .	ADV ADJ VERB ADP NOUN VERB CCONJ ADJ VERB PUNCT
Bu işi sadece iyi bir ekip olmayı başarırsak üstesinden gelebiliriz .	DET NOUN ADV ADJ DET NOUN VERB PUNCT ADJ VERB PUNCT
Bugün telefonumun şarjı bitti ve kimseyle iletişim kuramadım .	NOUN NOUN NOUN VERB CCONJ NOUN NOUN VERB PUNCT
Yeni taşındığımız evin geniş ve aydınlık salonu beni çok mutlu etti .	ADJ DET NOUN VERB CCONJ DET NOUN PRON ADV ADJ VERB PUNCT
Tatilde konakladığımız otelin odaları beklediğimiz kadar temiz değildi ve bu bizi rahatsız etti .	NOUN VERB PUNCT NOUN VERB ADP ADJ AUX CCONJ DET NOUN ADJ VERB PUNCT
Televizyonu taşıyan adamlara dikkat etmelerini söylememe rağmen beni dinlemeden kendi istediklerini yaptılar .	AUX PUNCT NOUN NOUN VERB VERB ADP PRON VERB PUNCT NOUN VERB PUNCT
Bugün deniz kenarında yürüyüş yaptım ve çok huzur buldum .	NOUN NOUN NOUN NOUN VERB CCONJ ADV NOUN VERB PUNCT
Yeni aldığım telefon bozuldu ve tamire göndermek zorunda kaldım .	ADJ VERB NOUN VERB CCONJ NOUN VERB ADJ VERB PUNCT
Sabah kahvaltıda sıcak kruvasan yedim ve çok sevdim .	NOUN NOUN ADJ NOUN VERB CCONJ ADV VERB PUNCT
Bu kitaptan beklediğim verimi almadığımı düşünmüyor değilim .	DET NOUN VERB PUNCT NOUN VERB AUX PUNCT
Ziyarete gittiğimiz sahil kasabasında hem güneşin doğuşunu izledim hem de sakinliğiyle huzur buldum .	NOUN VERB NOUN VERB CCONJ NOUN NOUN VERB CCONJ CCONJ NOUN NOUN VERB PUNCT
Bugün iş yerinde çok başarılı bir sunum yaptım .	NOUN NOUN NOUN ADV ADJ DET NOUN VERB PUNCT
Sabah otobüsü kaçırdım ve işe geç kaldım .	NOUN NOUN VERB CCONJ NOUN ADV VERB PUNCT
Bilgisayarım , tam teslim edeceğim projeyi kaydetmeden kapanınca her şeyi baştan yapmak zorunda kaldım .	AUX PUNCT ADV NOUN VERB NOUN VERB PUNCT DET NOUN NOUN VERB ADJ VERB PUNCT
Yeni aldığım kitabın konusu çok ilgi çekici ydi .	ADJ VERB NOUN NOUN ADV ADJ NOUN AUX PUNCT
İş görüşmesine geç kaldığımı düşünüyordum ama toplantıdan önce mola verdiklerini öğrenince rahatladım .	AUX PUNCT ADV ADJ VERB CCONJ NOUN ADP NOUN VERB NOUN VERB PUNCT
Yeni aldığım puzzle , hem zihnimi meşgul etti hem de tamamladığımda büyük bir mutluluk verdi .	ADJ VERB VERB PUNCT CCONJ NOUN NOUN VERB CCONJ CCONJ ADV ADJ DET NOUN VERB PUNCT
Sabah kahvaltıda çay döküldü ve masayı temizlemek zorunda kaldım .	NOUN NOUN NOUN VERB CCONJ NOUN VERB ADJ VERB PUNCT
Bugün hava çok sıcaktı ve dışarıda duramadım .	NOUN NOUN ADV VERB CCONJ NOUN VERB PUNCT
Bugün güneş li bir hava vardı , dışarı çıkıp yürüyüş yaptım .	NOUN NOUN ADP DET NOUN VERB PUNCT NOUN VERB NOUN VERB PUNCT
Sabah kahvaltıda ekmek bayat olduğu için yiyemedim .	NOUN NOUN NOUN NOUN VERB ADP VERB PUNCT
Bu oyunu oynamaya karar verdiğimiz zaman bu kadar sıkılacağımızı düşünmemiştik .	DET NOUN VERB NOUN VERB NOUN DET ADP NOUN VERB PUNCT
Sabah spor yaparak başladığım gün , enerjim ve motivasyonumun yüksek olmasını sağladı .	NOUN NOUN VERB PUNCT NOUN PUNCT NOUN CCONJ NOUN ADJ VERB VERB PUNCT
Bilgisayarım sürekli kapanıyor ve işlerimi yetiştiremiyorum .	NOUN ADV VERB CCONJ NOUN VERB PUNCT
Bugün sınav sonuçlarımı öğrendim ; derslerden biri çok iyi geçmiş , ama diğeri beklediğim gibi değildi .	NOUN NOUN NOUN VERB PUNCT NOUN PRON ADV ADJ VERB PUNCT CCONJ NOUN VERB ADP AUX PUNCT
Akşam yemeğinde çok lezzet li bir pizza yediğimi düşünüyorum .	NOUN NOUN ADV NOUN ADP DET NOUN VERB VERB PUNCT
15 gün dür ya oturuyorum ya uyuyorum , bu durumdan hiç memnun değilim .	NUM NOUN VERB CCONJ VERB CCONJ VERB PUNCT DET NOUN ADV ADJ AUX PUNCT
Yeni bir hobi edindim ve bu hobi sayesinde çok daha mutlu hissetmeye başladım .	ADJ DET NOUN VERB CCONJ DET NOUN NOUN ADV ADV ADJ NOUN VERB PUNCT
Sabah yürüyüş yapmak için dışarı çıktım , fakat yağmur yağmaya başlayınca geri dönmek zorunda kaldım .	NOUN NOUN VERB ADP NOUN VERB PUNCT CCONJ NOUN VERB PUNCT ADJ VERB ADJ VERB PUNCT
Gittiğimiz parkın sakinliği ve kuşların sesi beni derinden etkiledi , huzur buldum .	DET NOUN VERB CCONJ NOUN NOUN PRON ADJ VERB PUNCT NOUN VERB PUNCT
Yeni aldığım tişört , ilk yıkamada rengi solduğu için hayal kırıklığına uğradım .	ADJ VERB VERB PUNCT ADJ DET NOUN VERB ADP NOUN NOUN VERB PUNCT
Yeni aldığım ayakkabı ayağıma iyi geldi sanmıştım ama hem sıkı hem de rahatsız olduğu için iade etmek zorunda kaldım .	ADJ VERB PUNCT NOUN ADJ VERB PUNCT CCONJ CCONJ ADJ VERB CCONJ ADJ VERB ADP NOUN VERB ADJ VERB PUNCT
Sabah erkenden keyifle kalkıp kahvaltı hazırladım , ama ekmek bayat olduğu için keyfim kaçtı .	NOUN VERB NOUN VERB NOUN VERB PUNCT CCONJ NOUN NOUN VERB ADP NOUN VERB PUNCT
Bugün uzun zaman dır görmediğim bir arkadaşımı gördüm .	NOUN ADJ NOUN ADP ADJ DET NOUN VERB PUNCT
Bilgisayarımın güncellemesi tam sunum sırasında başladı ve işlerim aksadı .	AUX PUNCT ADV NOUN NOUN VERB CCONJ NOUN VERB PUNCT
Arkadaşlarımın yaptığı sürpriz doğum günü kutlaması beni çok mutlu etti .	NOUN VERB NOUN NOUN NOUN VERB PRON ADV ADJ VERB PUNCT
Çantamın askısı koptu ve eşyalarım yere döküldü .	DET NOUN VERB CCONJ NOUN NOUN VERB PUNCT
Fırtınanın ne kadar uzun süreceğini düşünmek beni karamsarlığa sürüklemişti , ancak gökkuşağını gördüğümde bütün bu endişelerim anlamsızlaştı .	CCONJ PRON ADP ADJ VERB PUNCT PRON NOUN VERB PUNCT CCONJ NOUN VERB ADJ DET NOUN VERB PUNCT
Bugün güzel başlamıştı ama işlerimin hiçbirini yetiştiremedim .	NOUN ADJ VERB CCONJ NOUN NOUN VERB PUNCT
Kütüphanede aradığım kitabı buldum ve hemen okumaya başladım .	NOUN VERB NOUN VERB CCONJ ADV ADJ VERB PUNCT
Akşam yemeğinde çorbamı bitirmediğim için annem bana çok kızdı .	NOUN NOUN NOUN VERB ADP NOUN PRON ADV VERB PUNCT
Bugün uzun süre dir beklediğim kitap kargom geldi , ancak kitabın kapağı yırtılmıştı ve moralim bozuldu .	NOUN ADJ NOUN AUX PUNCT NOUN NOUN VERB PUNCT CCONJ NOUN NOUN VERB CCONJ NOUN VERB PUNCT
Normalde uzun yolu hiç sevmem ama gittiğim bu doğa yürüyüşü , hem fiziksel hem de ruhsal olarak çok iyi geldi .	ADV ADJ NOUN ADV VERB CCONJ VERB DET NOUN VERB PUNCT CCONJ ADJ VERB CCONJ NOUN ADP ADV ADJ VERB PUNCT
Sabah uyandığımda çok üşümüştüm , kalorifer yanmıyordu .	NOUN VERB ADV VERB PUNCT NOUN VERB PUNCT
Arkadaşlarımın düzenlediği etkinlik çok keyif li geçti .	AUX PUNCT NOUN ADV NOUN ADP VERB PUNCT
Bugün sınavdan düşük not aldığım için çok üzgünüm .	NOUN NOUN ADJ NOUN VERB ADP ADV VERB PUNCT
Sabah kahvaltıda taze ekmek vardı ve çok lezzetli ydi .	NOUN NOUN ADJ NOUN VERB CCONJ ADV ADJ AUX PUNCT
Spor salonunda yaptığım egzersizler beni çok rahatlattı .	DET NOUN VERB PUNCT PRON ADV VERB PUNCT
Sabah çay bardağımı düşürdüm ve kırdım .	NOUN NOUN NOUN VERB CCONJ VERB PUNCT
Yeni aldığım kahve makinesi , sabah kahvaltımı çok keyif li hale getirmedi değil .	ADJ VERB NOUN VERB PUNCT NOUN NOUN ADV NOUN ADP NOUN VERB AUX PUNCT
Bilgisayarım tam çalışacağım sırada bozulduğu için işlerim aksadı .	NOUN ADV VERB NOUN VERB ADP NOUN VERB PUNCT
Gittiğim restoranda ki yemekler hem geç geldi hem de soğuktu .	DET NOUN ADP NOUN CCONJ ADV VERB CCONJ CCONJ VERB PUNCT
Tatilde okyanus manzarası eşliğinde oturmak beni huzurla doldursa da çok para harcamış oldum .	NOUN NOUN NOUN NOUN VERB PRON ADV VERB CCONJ ADV NOUN VERB VERB PUNCT
Bugün alışveriş yaparken cüzdanımı unuttuğum için ödeme yapamadım .	NOUN NOUN VERB NOUN VERB ADP NOUN VERB PUNCT
Sabah erkenden kalkıp sahilde yürüyüş yaptım ve enerji doluydum .	NOUN ADV VERB PUNCT NOUN VERB CCONJ NOUN VERB PUNCT
Yeni aldığım kitap tam da hayal ettiğim gibi çıktı .	ADJ VERB NOUN ADV CCONJ NOUN VERB ADP VERB PUNCT
Bugün işlerimi tamamlamak için çok uğraştım ama yetiştiremedim .	NOUN NOUN VERB ADP ADV VERB CCONJ VERB PUNCT
Arkadaşlarımla piknik yapmak , günümü daha güzel hale getirmedi değil .	DET NOUN VERB PUNCT NOUN ADV ADJ NOUN VERB AUX PUNCT
Sabah otobüs bozuldu ve işe geç kaldım .	NOUN NOUN VERB CCONJ NOUN ADV VERB PUNCT
Yeni bir yemek tarifi denedim ve çok lezzet li oldu .	ADJ DET NOUN NOUN VERB CCONJ ADV NOUN ADP VERB PUNCT
Telefonumun ekranı düştü ve tamamen kırıldı .	NOUN NOUN VERB CCONJ ADV VERB PUNCT
Arkadaşlarımla sinemaya gidip yeni çıkan filmi izledik , film çok berbattı .	DET NOUN VERB ADJ VERB NOUN VERB PUNCT NOUN ADV VERB PUNCT
Yolda yürürken çukura düştüm , neyse ki bir şey olmadı .	NOUN VERB NOUN VERB PUNCT NOUN ADP DET NOUN VERB PUNCT
Sabah kahvaltıda portakal suyunun tadı mükemmeldi .	NOUN NOUN NOUN NOUN NOUN VERB PUNCT
Bugün internet kesildiği için işlerimi yapamadım .	NOUN NOUN VERB ADP NOUN VERB PUNCT
Roma ' da gittiğimiz kafenin bahçesi huzur verici ydi .	AUX PUNCT CCONJ VERB PUNCT NOUN NOUN NOUN AUX PUNCT
Bugün tamir ettirmeye çalıştığım bilgisayarı çalıştırabildim ama tekrar bozuldu .	NOUN NOUN VERB PUNCT NOUN VERB CCONJ ADV VERB PUNCT
Bahçede oturup kitap okumak beni çok mutlu etmiyor değil .	NOUN VERB NOUN VERB PRON ADV ADJ VERB AUX PUNCT
Çamaşır makinem arızalandığı için tüm işlerim aksamadı değil .	DET NOUN VERB ADP DET NOUN VERB AUX PUNCT
Sabah erkenden uyanıp yeni bir günün keyfini çıkardım .	NOUN VERB PUNCT ADJ DET NOUN NOUN VERB PUNCT
Akşam otururken elektrik kesildi ve karanlıkta kaldık .	NOUN VERB NOUN VERB CCONJ NOUN VERB PUNCT
Yeni taşındığım evde ki manzara beni her gün mutlu etmiyor değil .	ADJ DET NOUN ADP NOUN PRON DET NOUN ADJ VERB AUX PUNCT
Bugün alışverişte indirimden yararlanamadığım için üzgünüm .	NOUN NOUN NOUN VERB ADP VERB PUNCT
Yeni aldığım ayakkabılar çok rahat ve şık .	ADJ VERB PUNCT ADV ADJ CCONJ VERB PUNCT
Call of Duty ' i çok oynamak istemiyor değilim ama ekran kartım yeterli değil .	DET NOUN VERB PUNCT PRON ADV ADJ VERB PUNCT CCONJ NOUN ADV ADJ AUX PUNCT
Yazları kumsalda yürüyüş yapmak beni çok rahatlatıyor .	AUX PUNCT NOUN VERB PRON ADV VERB PUNCT
Sabah kahvaltıda çayın tadı çok güzeldi .	NOUN NOUN NOUN NOUN ADV VERB PUNCT
İş yerinde ki sunumum muhteşem olmuştu ama projem çöktü .	DET NOUN ADP NOUN ADJ VERB CCONJ NOUN VERB PUNCT
Bugün arkadaşımın doğum gününü kutlamak beni çok mutlu etti .	NOUN NOUN NOUN NOUN VERB PRON ADV ADJ VERB PUNCT
Restoranda ki servis çok yavaş olduğu için sinirlendim .	NOUN ADP NOUN ADV ADJ VERB ADP VERB PUNCT
Akşam üzeri oturup yıldızları izlemek çok huzur verici ydi .	NOUN NOUN VERB NOUN VERB ADV NOUN NOUN AUX PUNCT
Belki de sorun bende dir diye düşünmüyor değildim , haklı da çıktım .	PROPN CCONJ NOUN ADJ AUX PUNCT NOUN VERB PUNCT ADJ CCONJ VERB PUNCT
Sabah çiçekleri sularken mis gibi bir koku aldım .	NOUN NOUN VERB NOUN ADP DET NOUN VERB PUNCT
Yolda düşürdüğüm anahtarlığı bulamadığım için kapıda kaldım .	NOUN VERB NOUN VERB ADP NOUN VERB PUNCT
Çocukların sokakta oynadığı oyunlar bana çocukluğumu hatırlattı ve içimi bir sıcaklık kapladı .	DET NOUN VERB PUNCT PRON NOUN VERB CCONJ ADJ DET NOUN VERB PUNCT
Sabah kahvaltıya otururken ekmek bitmişti ve çayın şekeri fazla geldiği için kahvaltı keyfim kaçtı .	NOUN NOUN VERB NOUN VERB CCONJ NOUN NOUN ADV VERB ADP NOUN NOUN VERB PUNCT
Kitap okuduğumda dünyadan uzaklaşıyor , bambaşka bir hayal alemine dalıyorum .	NOUN VERB NOUN VERB PUNCT ADJ DET NOUN NOUN VERB PUNCT
Çamaşır makinem tüm çamaşırları yanlış programda yıkadığı için moralim bozuldu .	AUX PUNCT DET NOUN ADJ NOUN VERB ADP NOUN VERB PUNCT
Yeni öğrendiğim yemek tarifi tam hayalimde ki gibi oldu .	ADJ VERB NOUN NOUN ADJ NOUN ADP ADP VERB PUNCT
Bugün toplantıda istediğim gibi konuşamadım ve utandım .	NOUN NOUN VERB ADP VERB CCONJ VERB PUNCT
Sabah spor yapmak beni tüm gün boyunca enerjik tutmadı değil .	NOUN NOUN VERB PRON DET NOUN ADP ADJ VERB AUX PUNCT
Yeni bir dil öğrenmenin zor olduğunu düşünüyordum , fakat çalışmaya başlayınca düşündüğüm kadar karmaşık olmadığını fark ettim .	ADJ DET NOUN VERB ADJ VERB VERB PUNCT CCONJ DET NOUN VERB ADP ADJ VERB NOUN VERB PUNCT
Restoranda sipariş ettiğim yemek eksik geldiği için şikayet ettim .	DET NOUN VERB NOUN ADJ VERB ADP NOUN VERB PUNCT
Akşam yemeğinde tatlı yedim ve tadı mükemmeldi .	NOUN NOUN ADJ VERB CCONJ NOUN VERB PUNCT
Sabah otobüste yer bulamadım ve ayakta yolculuk yaptım .	NOUN NOUN NOUN VERB CCONJ NOUN NOUN VERB PUNCT
Bugün kahve içip arkadaşlarımla sohbet ettim , çok eğlenceli ydi .	NOUN NOUN VERB PUNCT NOUN VERB PUNCT ADV ADJ AUX PUNCT
Arkadaşımın düğününe gitmeyi çok istiyordum , ancak hasta olduğum için katılamadım .	NOUN VERB PUNCT ADV VERB PUNCT ADV ADJ VERB ADP VERB PUNCT
Zamanaltı podcast tiyatrosunu dinlerken kendimi çok rahatlamış hissediyorum .	DET NOUN VERB PUNCT PRON ADV ADJ VERB PUNCT
En sevdiğim duygu yeni bir kitabın kapağını açtığımda hissettiğim heyecan dır .	ADV VERB PUNCT ADJ DET NOUN NOUN VERB VERB NOUN AUX PUNCT
Yeni aldığım çiçek saksısı balkonuma tam uymuştu ama çok sinek geldiği için kaldırmak zorunda kaldım .	ADJ VERB NOUN VERB PUNCT ADV VERB CCONJ ADV ADJ VERB ADP ADV ADJ VERB PUNCT
Bugün işlerimizi tamamlayamamız ne güzel oldu ya ( ! )	NOUN VERB PUNCT PRON ADJ VERB CCONJ VERB PUNCT PUNCT
Sabah kahvaltıda yediğim kruvasan çok güzeldi ama kahvem çok lezzet siz olmuştu .	NOUN NOUN VERB PUNCT ADV VERB CCONJ NOUN ADV NOUN ADP VERB PUNCT
Viyana ' da kaldığımız otelin yemekleri lezzetsizdi ve hiç keyif almadık .	AUX PUNCT CCONJ DET NOUN NOUN VERB CCONJ ADV NOUN VERB PUNCT
Yeni aldığım kitap , içeriğiyle beni çok etkiledi .	ADJ VERB NOUN PUNCT NOUN PRON ADV VERB PUNCT
Bugün otobüs beklerken çok üşüdüm ve hasta oldum .	NOUN NOUN VERB ADV VERB CCONJ ADJ VERB PUNCT
Parkta oynayan çocukların neşesi beni çok mutlu etti .	AUX PUNCT NOUN NOUN PRON ADV ADJ VERB PUNCT
Bilgisayarım aniden bozuldu ve işlerim yarım kaldı .	NOUN ADV VERB CCONJ NOUN ADJ VERB PUNCT
Hala kulaklarım duymuyor ama çok şükür hayattayım işte .	DET NOUN VERB CCONJ ADV ADJ NOUN VERB PUNCT
Bugün alışverişte uzun kuyruklarda beklemek zorunda kaldım .	NOUN NOUN ADJ NOUN VERB ADJ VERB PUNCT
Yeni aldığım mont hem sıcak tutuyor hem de çok şık .	ADJ VERB PUNCT CCONJ ADJ VERB CCONJ CCONJ ADV VERB PUNCT
İki eski flörtü aynı odaya kapatmanın iyi bir fikir olmadığını yeni işime başladığımda birinci elden anlamış oldum .	NUM ADJ NOUN ADJ NOUN VERB ADJ DET NOUN VERB ADJ NOUN VERB PUNCT NOUN VERB VERB PUNCT
Deniz kenarında oturup dalgaların sesini dinledim , çok keyifli ydi .	DET NOUN VERB PUNCT NOUN VERB PUNCT ADV ADJ AUX PUNCT
Bugün trafikte çok zaman kaybettim ve işlerimi yetiştiremedim .	NOUN NOUN ADV NOUN VERB CCONJ NOUN VERB PUNCT
Yeni tarif denemek korkut ucu olsa da sonuç harika ydı .	ADJ NOUN VERB PUNCT NOUN VERB CCONJ NOUN ADJ AUX PUNCT
Sabah çay yaparken bardağı kırdım ve her yer çay oldu .	NOUN NOUN VERB NOUN VERB CCONJ DET NOUN NOUN VERB PUNCT
Ben kimseye yardım etmek isteyemedim ama şimdi bundan başka bir şey istemiyorum .	PRON NOUN NOUN VERB PUNCT CCONJ ADV ADV ADJ DET NOUN VERB PUNCT
Bugün restoranda ki servis çok yavaştı ve aç kaldım .	NOUN NOUN ADP NOUN ADV VERB CCONJ ADJ VERB PUNCT
Yeni aldığım masa lambası odamı çok aydınlattı .	ADJ VERB NOUN VERB PUNCT ADV VERB PUNCT
Hafta sonu planımız tam istediğim gibi gerçekleşmedi ; hiç eğlenemedik .	ADV ADJ NOUN ADV VERB ADP VERB PUNCT ADV VERB PUNCT
Bugün bahçede oturup meditasyon yaptım , günümün devamını o kadar iyi etkiledi ki .	NOUN NOUN VERB NOUN VERB PUNCT NOUN NOUN PRON ADP ADJ VERB ADP PUNCT
Sabah aceleyle evden çıktım ve anahtarımı unuttum .	NOUN VERB NOUN VERB CCONJ NOUN VERB PUNCT
Yeni bir dil öğrenmeye başladım ve süreç beni çok heyecanlandırıyor .	ADJ DET NOUN VERB VERB CCONJ NOUN PRON ADV VERB PUNCT
Bugün restorana gittiğimizde hem yemekler çok geç geldi hem de tatları istediğimiz gibi değildi .	NOUN NOUN VERB CCONJ NOUN ADV ADV VERB CCONJ CCONJ NOUN VERB ADP AUX PUNCT
Bir yabancının bana uzattığı yardım eli , hayata olan güvenimi tazelemek için yeterli ydi .	DET NOUN PRON VERB NOUN VERB PUNCT NOUN VERB NOUN VERB ADP ADJ AUX PUNCT
Bugün yolda lastiğim patladı ve uzun süre beklemek zorunda kaldım .	NOUN NOUN NOUN VERB CCONJ ADJ NOUN VERB ADJ VERB PUNCT
Sabah güne kahveyle başlamak beni çok enerjik yaptı .	NOUN NOUN NOUN VERB PRON ADV ADJ VERB PUNCT
Bugün yağmur nedeniyle dışarı çıkamadım ve işlerimi halledemedim .	NOUN NOUN NOUN NOUN VERB CCONJ NOUN VERB PUNCT
Yeni bir hobi olarak video oyunlarına başladım , açıkçası beklediğim gibi eğlence li değildi .	ADJ DET NOUN ADP NOUN NOUN VERB PUNCT ADV VERB ADP NOUN ADP AUX PUNCT
Bilgisayarımın şarj aleti kaybolduğu için işlerimi yapamadım .	AUX PUNCT NOUN VERB ADP NOUN VERB PUNCT
Gittiğim ilk konserin atmosferi muhteşemdi , kendimi çok şanslı hissediyorum .	ADV ADJ NOUN NOUN VERB PUNCT PRON ADV ADJ VERB PUNCT
Bugün markette çok uzun kuyruklar vardı ve zaman kaybettim .	NOUN NOUN ADV ADJ NOUN VERB CCONJ NOUN VERB PUNCT
Sabah kahvaltıda taze sıkılmış portakal suyu içtim ve çok sevdim .	NOUN NOUN ADJ VERB PUNCT NOUN VERB CCONJ ADV VERB PUNCT
Bugün otobüs arızalandığı için eve taksiyle dönmek zorunda kaldım .	NOUN NOUN VERB ADP NOUN NOUN VERB ADJ VERB PUNCT
Akşam kitap okuyarak rahatladım ve güzel bir uyku çektim .	NOUN NOUN VERB VERB CCONJ ADJ DET NOUN VERB PUNCT
Gittiğimiz sahilin suyu çok pisti , hiç yüzemedim .	VERB PUNCT NOUN ADV VERB PUNCT ADV VERB PUNCT
Yeni aldığım çantayı çok beğendim , tam hayalimde ki gibi ydi .	ADJ VERB PUNCT ADV VERB PUNCT ADV NOUN ADP ADP AUX PUNCT
Bugün toplantıya katılmayı unuttuğum için çok mahcup oldum .	NOUN NOUN VERB VERB ADP ADV ADJ VERB PUNCT
Sabah spordan sonra çok enerjik hissettim ve işlerimi hızlıca bitirdim .	NOUN NOUN ADP ADV ADJ VERB CCONJ NOUN ADV VERB PUNCT
Telefonumun ekranı kırıldığı için kimseyle iletişim kuramadım .	NOUN NOUN VERB ADP NOUN NOUN VERB PUNCT
Yeni aldığım masa lambasının tasarımını çok beğendim , ancak ışığının çok yetersiz olduğunu fark edince kullanışsız olduğunu anladım .	ADJ VERB NOUN VERB PUNCT ADV VERB PUNCT CCONJ NOUN ADV ADJ VERB NOUN VERB NOUN VERB VERB PUNCT
Akşam tam yemeği hazırlarken elektrik kesildi .	NOUN ADJ NOUN VERB NOUN VERB PUNCT
Yeni aldığım kulaklık teknolojik olarak çok üst düzeyde , müzik keyfimi katladı .	ADJ VERB PUNCT NOUN ADP ADV ADJ VERB PUNCT NOUN NOUN VERB PUNCT
Bugün internet kesintisi nedeniyle işlerim yarım kaldı .	NOUN NOUN NOUN NOUN NOUN ADJ VERB PUNCT
Tatilde yeni insanlarla tanışmanın beni çok eğlendireceğini düşünmüştüm ama beklediğim gibi gitmedi .	NOUN ADJ NOUN VERB PRON ADV ADJ VERB CCONJ VERB ADP VERB PUNCT
Sabah çay bardağını yanlışlıkla devirdim ama neyse ki yere dökülmedi .	NOUN NOUN NOUN NOUN VERB CCONJ NOUN ADP NOUN VERB PUNCT
Gittiğim konser beni çok eğlendirdi , unutulmaz bir deneyimdi .	DET NOUN PRON ADV VERB PUNCT ADJ DET NOUN PUNCT
Sabah aceleden kahvaltıyı atladığım için gün boyunca enerjisizdim .	NOUN NOUN NOUN VERB ADP NOUN ADP VERB PUNCT
Bugün doğum günüme gelen sürpriz hediye beni çok mutlu etti .	NOUN NOUN NOUN VERB NOUN NOUN PRON ADV ADJ VERB PUNCT
Arkadaşlarımla buluşmak için çıktığımda yağmur yağdı ve tamamen ıslandım çünkkü şemsiyemi unutmuştum .	NOUN VERB ADP VERB NOUN VERB CCONJ ADV VERB PUNCT NOUN VERB PUNCT
Yeni bir tarif denedim ve sonuç çok lezzet li oldu .	ADJ DET NOUN VERB CCONJ NOUN ADV NOUN ADP VERB PUNCT
Bugün tamirci çağırdım ama gelen kişi geç kaldı ve işim aksadı .	NOUN NOUN VERB CCONJ VERB NOUN ADV VERB CCONJ NOUN VERB PUNCT
Şubat ayında gittiğim köy çok ses siz ve huzurlu ydu .	DET NOUN VERB PUNCT ADV NOUN VERB CCONJ ADJ AUX PUNCT
Gittiğimiz kafede istediğim yemekten yok tu , keyfim kaçtı .	DET NOUN VERB PUNCT ADJ AUX PUNCT NOUN VERB PUNCT
Akşam üzeri yürüyüş yapmak günün yorgunluğunu atar diye düşünmüştüm ve haklıymışım .	NOUN NOUN NOUN VERB NOUN NOUN VERB ADP VERB CCONJ VERB PUNCT
Telefonum şarjda takılı yken birden kapandı ve çalışmadı .	DET NOUN VERB PUNCT ADV VERB CCONJ VERB PUNCT
Yeni aldığım defteri alırken tereddütlerim vardı ama çok kaliteli çıktı ve üzerine yazmak çok keyif li .	ADJ VERB NOUN VERB NOUN VERB CCONJ ADV ADJ VERB CCONJ NOUN VERB ADV NOUN ADP PUNCT
Restoranda ki yemeğin tuzu fazla olduğu için keyfim kaçtı .	NOUN ADP NOUN NOUN ADV VERB ADP NOUN VERB PUNCT
Büyüdüğüm şehrin manzarası düşündükçe beni mutlu ediyor ama o zamanlara dönmek istemem .	AUX PUNCT NOUN VERB PRON ADJ VERB CCONJ DET NOUN VERB VERB PUNCT
Bugün bankada sıra beklemekten çok sıkıldım .	NOUN NOUN VERB PUNCT ADV VERB PUNCT
Sabah bahçede oturup kahvemi içtim , çok huzurlu ydum .	NOUN NOUN VERB NOUN VERB PUNCT ADV ADJ AUX PUNCT
Televizyonun açılması çok yavaş olduğu için dizinin finalini kaçırdım , neyse ki arkadaşım kaydediyormuş .	AUX PUNCT ADV ADJ VERB ADP NOUN NOUN VERB PUNCT NOUN ADP NOUN VERB PUNCT
Yeni bir işe başladım ve işlerim gayet yolunda gidiyor .	ADJ DET NOUN VERB CCONJ NOUN VERB NOUN VERB PUNCT
Bugün teslim aldığım kargoda ki ürün hatalı ydı , kargocu geri almadan gitti .	NOUN NOUN VERB NOUN ADP NOUN ADJ AUX PUNCT NOUN ADJ NOUN VERB PUNCT
Tatilde kamp yapmak , doğayla iç içe olmaktan nefret edeceğimi sanıyordum ama denediğimde hoşuma gitti .	NOUN NOUN VERB PUNCT ADV ADJ NOUN VERB NOUN VERB PUNCT CCONJ DET NOUN VERB PUNCT
Sabah kahvaltıda bardak kırıldığı için işlerim aksadı .	NOUN NOUN NOUN VERB ADP NOUN VERB PUNCT
Simülasyon teorisi üzerine bir tartışma programı izledim ve çok ilginç buldum .	AUX PUNCT NOUN DET NOUN NOUN VERB CCONJ ADV ADJ VERB PUNCT
Akşam otobüs saatini kaçırdım ve eve geç kaldım .	NOUN NOUN NOUN VERB CCONJ NOUN ADV VERB PUNCT
Yeni öğrendiğim dil bilgisi kuralları bana çok mantık lı geldi .	ADJ VERB NOUN VERB PUNCT PRON ADV NOUN ADP VERB PUNCT
Telefonum suya düştü ama hemen geri aldığım için çalışıyor .	DET NOUN VERB CCONJ ADV ADJ VERB ADP VERB PUNCT
Sabah kalktığımda caddeden gelen araba seslerini duymamak beni şaşırttı ve mutlu etti .	NOUN VERB NOUN VERB NOUN NOUN VERB PRON VERB CCONJ ADJ VERB PUNCT
Bugün babamın vefat haberini aldım .	NOUN NOUN NOUN NOUN VERB PUNCT
İnsan doğasının temelinde iyi olmak yattığını düşünürüm hep .	AUX PUNCT ADV ADJ VERB PUNCT NOUN VERB PUNCT
Yeni aldığım kitap ilk sayfadan itibaren ilgimi çekmedi değil .	ADJ VERB NOUN ADJ VERB PUNCT NOUN VERB AUX PUNCT
Kozmozun korkut ucu karanlığında yavaş yavaş ölümümüze ilerliyoruz .	DET NOUN VERB PUNCT ADJ DET NOUN VERB PUNCT
Bazen yaptığım eylemlerin hayatımda yaşanan olayları etkilemediğini düşünüp üzülüyorum , sonra aklıma çok para kazandığım geliyor .	ADV VERB PUNCT NOUN VERB NOUN VERB NOUN VERB PUNCT ADP NOUN ADV NOUN VERB VERB PUNCT
Bugün elektrik faturası çok yüksek geldiği için sinirlendim .	NOUN NOUN NOUN ADV ADJ VERB ADP VERB PUNCT
Yeni aldığım figürü boyadığımda çok güzel olacağını düşünüyorum .	ADJ VERB PUNCT PRON ADV ADJ ADJ VERB PUNCT
Bugün işe gitmek için sabahın köründe kalkmaktan ne kadar mutluyum bir bilsen ( ! )	NOUN NOUN VERB ADP NOUN VERB PUNCT PRON ADP ADJ DET NOUN VERB PUNCT PUNCT
Tatilde gittiğim köy , sessizliği ve doğallığıyla beni büyüledi .	NOUN VERB VERB PUNCT NOUN CCONJ NOUN PRON VERB PUNCT
Bugün trafikte uzun süre beklemek zorunda kaldım .	NOUN NOUN ADJ NOUN VERB ADJ VERB PUNCT
Sabah kahvaltıda börek yemek kulağa iyi gelmiyor değil .	NOUN NOUN NOUN NOUN NOUN ADJ VERB AUX PUNCT
Yeni bir arkadaşlık kurdum ve sohbetimiz çok keyifli ydi .	ADJ DET NOUN VERB CCONJ NOUN ADV ADJ AUX PUNCT
Bugün alışverişte fiyatlar çok yüksekti , hiçbir şey alamadım .	NOUN NOUN NOUN ADV VERB PUNCT DET NOUN VERB PUNCT
Sabah kahvaltıda sıcak simit yemek çok keyif verdi .	NOUN NOUN ADJ DET NOUN ADV NOUN VERB PUNCT
Telefonumun şarjı erken bittiği için iletişim kurmakta zorlandım .	NOUN NOUN ADV VERB ADP NOUN VERB VERB PUNCT
Uzun süre dir depresyonda ydım , hayatımın aşkı ile tanışana kadar .	ADJ NOUN AUX PUNCT VERB PUNCT NOUN VERB CCONJ NOUN ADP PUNCT
Sabah işe giderken trafiğe takıldım ve geç kaldım .	NOUN NOUN VERB NOUN VERB CCONJ ADV VERB PUNCT
Yeni bir beceri öğrenmek beni çok motive etti .	ADJ DET NOUN VERB PRON ADV ADJ VERB PUNCT
Bugün tamirci eve gelmediği için işlerim aksadı .	NOUN NOUN NOUN VERB ADP NOUN VERB PUNCT
Sabah çiçeklerin kokusuyla uyanmak beni çok mutlu etti .	NOUN NOUN VERB PUNCT PRON ADV ADJ VERB PUNCT
Bugün koşuya çıktığımda ayağım burkuldu ve çok canım yandı .	NOUN NOUN VERB NOUN VERB CCONJ ADV NOUN VERB PUNCT
Sabah kahvemi alıp balkonda oturdum , manzara muhteşemdi .	NOUN NOUN VERB NOUN VERB PUNCT NOUN VERB PUNCT
Bugün kargo teslimatı çok geç yapıldığı için sinirlendim .	NOUN VERB PUNCT ADV ADV VERB ADP VERB PUNCT
Bir müzik uygulamasında rastgele çaldığım şarkı favorim oldu .	DET NOUN NOUN ADJ DET NOUN NOUN VERB PUNCT
Telefonum düşüp kırıldı ve tamir masrafı çok yüksek çıktı .	NOUN VERB VERB CCONJ NOUN NOUN ADV ADJ VERB PUNCT
Sabah yürüyüşünde dostlarımla buluşmak beni çok mutlu etti .	NOUN NOUN VERB PUNCT PRON ADV ADJ VERB PUNCT
Ailemin yanında olduğum için mutlu olmama gerekiyor ama değilim .	ADV ADJ VERB ADP ADJ VERB PUNCT CCONJ VERB PUNCT
Yeni aldığım kıyafet tam istediğim gibi ydi .	ADJ VERB PUNCT ADV VERB ADP AUX PUNCT
Bugün işlerimi bitiremeden uyuyakaldığım için çok üzgünüm .	NOUN NOUN VERB VERB ADP ADV VERB PUNCT
Tatilde yeni insanlarla tanışmak beni çok heyecanlandırdı .	NOUN ADJ NOUN VERB PRON ADV VERB PUNCT
Telefonumda depolama alanı kalmadığı için yeni uygulama indiremiyorum .	AUX PUNCT NOUN VERB ADP ADJ NOUN VERB PUNCT
Sabah kahvaltıda taze sıkılmış portakal suyu içtim ve çok sevdim .	NOUN NOUN ADJ VERB PUNCT NOUN VERB CCONJ ADV VERB PUNCT
Son senelerde cinayet oranları artmış durumda .	ADJ NOUN NOUN VERB PUNCT NOUN PUNCT
Beni hiçbir zaman dinlemiyorsun ki zaten .	PRON DET NOUN VERB ADP VERB PUNCT
Seni sevdiğim güne lanet olsun , senle beraber olmamalıydım .	PRON VERB NOUN NOUN VERB PUNCT PRON ADV VERB PUNCT
Güneşi görmeyeli günler olmuştu , depresyonum en üst safada ydı .	AUX PUNCT NOUN VERB PUNCT NOUN ADV ADJ NOUN AUX PUNCT
Mutfakta ki tabaklar ne kadar da temiz öyle ( ! )	PRON ADP NOUN PRON ADP CCONJ ADJ VERB PUNCT PUNCT PUNCT
Yeni evime bir türlü alışamadım .	ADJ NOUN DET ADJ VERB PUNCT
Sipariş ettiğim 3D yazıcının parçaları eksik geldi .	NOUN VERB PUNCT NOUN NOUN ADJ VERB PUNCT
Bu kitapta ki ana karakteri pek beğenmedim .	DET NOUN ADP NOUN NOUN ADV VERB PUNCT
Evimi böcekler sarmaladı , sanırım bir şeyler bozulmuş .	DET NOUN VERB PUNCT ADJ DET NOUN VERB PUNCT
İnternet hızım vadedilenden çok uzak .	AUX PUNCT NOUN ADV VERB PUNCT
Ona güvenmemin hata olduğunu söylediğinde seni dinlemeli ydim .	PRON VERB NOUN VERB PUNCT PRON ADV VERB PUNCT
Bu kadar rüzgar eseceğini tahmin edemedim , şimdi çok üşüyorum .	DET ADP NOUN VERB NOUN VERB PUNCT ADV ADV VERB PUNCT
Bu oyunu 300 saat oynamama rağmen hala çok kötüyüm .	DET NOUN VERB NOUN VERB ADP ADV ADV VERB PUNCT
Sınavlarımdan hiç tahmin ettiğim gibi sonuçlar alamadım .	PRON ADV NOUN VERB ADP NOUN VERB PUNCT
Milli Mücadele ile alakalı yaptığım sunum pek beğeni almadı .	AUX PUNCT CCONJ ADJ VERB PUNCT ADV ADJ VERB PUNCT
Balıke sir ' de yaşamanın bana kattığı hiçbir şey yok .	NOUN VERB PUNCT CCONJ NOUN PRON ADJ DET NOUN VERB PUNCT
Düşman bizle mücadele etmiyor bizi ezip geçmek istiyor .	AUX PUNCT NOUN VERB PUNCT NOUN VERB VERB PUNCT
Aldığım cilt bakım ürünleri ben aldıktan sonra indirime girmiş .	DET NOUN VERB PUNCT PRON VERB ADP NOUN VERB PUNCT
Hasta olduğumdan proje ödevim çok yavaş ilerliyor .	AUX PUNCT NOUN NOUN ADV ADJ VERB PUNCT
Japonca öğrenmenin bu kadar zor olacağını düşünmemiştim .	AUX PUNCT DET ADP ADJ ADJ VERB PUNCT
Telefonum sürekli şarjı bitmiş gibi davranıyor , hiç dayanmıyor .	NOUN ADV NOUN VERB ADP VERB PUNCT ADV VERB PUNCT
Yeni aldığım bilgisayarın performansı beklediğimden çok daha kötü çıktı .	ADJ VERB PUNCT NOUN VERB ADV ADV ADJ VERB PUNCT
Tatilde gitmek istediğim yerler , mevsim yüzünden tamamen kapalı ymış .	NOUN VERB VERB NOUN PUNCT NOUN NOUN ADV ADJ AUX PUNCT
Yıllar dır spor yapmama rağmen hala istediğim kiloya ulaşamadım .	NOUN ADP NOUN VERB ADP ADV VERB NOUN VERB PUNCT
Kışlık botlarım su geçiriyor , ayaklarım sürekli ıslak .	AUX PUNCT NOUN VERB PUNCT NOUN ADV VERB PUNCT
Otobüs yine gecikti , işe geç kalmaktan bıktım .	PRON ADV VERB PUNCT NOUN ADV ADJ VERB PUNCT
Arkadaşımın düğününde taktığım altın kaybolmuş .	DET NOUN VERB NOUN VERB PUNCT
Yeni aldığım telefon kılıfı telefonuma uymadı , boşuna almışım .	ADJ VERB PUNCT NOUN NOUN VERB PUNCT NOUN VERB PUNCT
Sabaha kadar çalıştım ama bitirmek istediğim proje hala eksik .	PRON ADP VERB CCONJ NOUN VERB NOUN ADV VERB PUNCT
Haftalarca çalıştığım iş görüşmesinden olumsuz yanıt aldım .	AUX PUNCT NOUN VERB PUNCT NOUN VERB PUNCT
Yeni evimde internet kurulumu hala yapılmadı , hiçbir şey yapamıyorum .	ADJ DET NOUN NOUN ADV VERB PUNCT DET NOUN VERB PUNCT
Sevdiğim dizinin finali beni inanılmaz hayal kırıklığına uğrattı .	DET NOUN NOUN PRON VERB NOUN NOUN VERB PUNCT
Verdiğim emeklerin karşılığını asla alamıyorum gibi hissediyorum .	AUX PUNCT NOUN ADV VERB ADP VERB PUNCT
Marketten aldığım süt bozuk çıktı , fark etmeden içtim .	NOUN VERB PUNCT ADJ VERB PUNCT NOUN VERB VERB PUNCT
Gitmek istediğim konsere bilet bulamadım , her yer dolu .	ADV VERB PUNCT NOUN VERB PUNCT DET NOUN VERB PUNCT
Komşularım sürekli kavga ediyor , evde huzur kalmadı .	PRON ADV NOUN VERB PUNCT NOUN NOUN VERB PUNCT
İş yerinde ki zam beklentim karşılanmadı , motivasyonum düştü .	DET NOUN ADP NOUN NOUN VERB PUNCT NOUN VERB PUNCT
Yıllar dır çiçek büyütmeye çalışıyorum ama hepsi soluyor .	NOUN ADP NOUN VERB VERB CCONJ PRON VERB PUNCT
En sevdiğim restoran menüsünden favori yemeğimi kaldırmış .	ADV VERB PUNCT NOUN ADJ NOUN VERB PUNCT
Şehirde ki hava kirliliği yüzünden nefes almak bile zorlaştı .	PRON ADP NOUN NOUN NOUN NOUN VERB ADV VERB PUNCT
Onu uzun süre unutmay çalışmadım değil ama hala hatırasını aklımdan çıkaramıyorum .	PRON ADJ NOUN VERB ADJ AUX CCONJ ADV ADJ NOUN VERB PUNCT
Eğer evrende insanlıktan farklı bir tür varsa ve elimizde ki teknoloji ile onları tespit edemiyorsak hapı yuttuk .	CCONJ NOUN NOUN ADJ DET NOUN VERB CCONJ NOUN ADP VERB CCONJ DET NOUN VERB NOUN VERB PUNCT
Kıyamet sonrası bir senaryoda hayatta kalmaya çalışırım ama muhtemelen günler içinde öldürülürüm .	AUX PUNCT DET NOUN NOUN VERB PUNCT CCONJ DET NOUN ADJ VERB PUNCT
Seneler önce almış olduğum oyuncağımı küçükken çok severdim , şimdi ise bana çok çocukça geliyor .	DET NOUN VERB VERB PUNCT ADV ADV VERB PUNCT ADV CCONJ PRON ADV ADJ VERB PUNCT
Arkadaşlığımız boyunca beni sevdiğini düşünmüyor değildim ama şu an anlıyorum ki beni hiç sevmiş değilsin .	AUX PUNCT PRON ADV VERB PUNCT CCONJ DET NOUN VERB CCONJ PRON ADV ADJ AUX PUNCT
Geçtiğimiz senelerde yaptığımız kutu oyunları etkinlikleri yılın şu zamanlarında pek başarılı olmazdı ve bu sene de aynen öyle oldu .	DET NOUN VERB PUNCT NOUN VERB PUNCT DET NOUN ADV ADJ VERB CCONJ DET NOUN CCONJ ADV ADV VERB PUNCT
Hayatım beklediğim bir yöne doğru gitmiyor gibi gözüküyor ve bu durum beni çok korkutuyor .	NOUN VERB DET NOUN ADJ VERB ADP VERB CCONJ DET NOUN PRON ADV VERB PUNCT
Witcher oyunlarını oynadıktan sonra kitaplarını çok beğeneceğim sandım ama bana çok sıkıcı geldiler .	DET NOUN VERB ADP NOUN ADV ADJ VERB CCONJ PRON ADV ADJ VERB PUNCT
Şu an burada bomboş oturmak ne kadar keyif li ( ! )	DET NOUN NOUN VERB PUNCT PRON ADP NOUN ADP VERB PUNCT PUNCT
Okültizm hakkında çok araştırmak istediğim çok konu var , başıma bir şey gelir diye korkuyorum .	DET NOUN ADV ADJ VERB ADV ADJ VERB PUNCT ADJ DET NOUN VERB ADP VERB PUNCT
Kardeşimin yüzüne baktığımda gördüğüm hayal kırıklığı beni çok utandırdı , belki de onunla yaşamaya hiç gelmemeli ydim .	DET NOUN VERB VERB NOUN NOUN PRON ADV VERB PUNCT ADV CCONJ NOUN VERB ADV ADJ AUX PUNCT
Caz müzğin tarihiyle alakalı bir kitap satın aldım ve çok merak etmiyor değildim ama işlerimin yoğunluğu yüzünden başlayamıyorum .	AUX PUNCT NOUN ADJ DET NOUN ADV VERB CCONJ ADV ADJ VERB PUNCT CCONJ NOUN NOUN NOUN VERB PUNCT
Bir tabloyu anlamaya çalışırken ressamın ne anlatmak istediğini asla çözemedim ve kendimi inanılmaz derecede yetersiz hissettim .	DET NOUN VERB VERB PUNCT PRON VERB PUNCT ADV VERB CCONJ PRON VERB NOUN ADJ VERB PUNCT
Bir zaman makinesi icat ettiğimi hayal ederken , onun geçmişi değil sadece yanlış anıları değiştirebileceğini fark etmek beni dehşete düşürdü .	DET NOUN NOUN VERB PUNCT NOUN VERB PUNCT PRON VERB CCONJ ADV ADJ NOUN VERB NOUN VERB PRON NOUN VERB PUNCT
Bir ağaç yaprağının damarlarında karmaşık bir şifre buldum ama bunun Rahibeler Birliği tarafından bırakıldığını fark ettim , onlara güven olmaz .	DET NOUN VERB PUNCT ADJ DET NOUN VERB CCONJ DET NOUN NOUN NOUN VERB NOUN VERB PUNCT NOUN NOUN VERB PUNCT
Bulutların her birinin birer gölge yaratık olduğunu düşündüğüm çocukluk fikri , bugün hâlâ içimde garip bir korku yaratıyor .	INTJ DET NOUN VERB PUNCT NOUN VERB PUNCT NOUN VERB PUNCT NOUN ADV ADJ ADJ DET NOUN VERB PUNCT
Yıllar dır hayalini kurduğum o romanı yazmaya başlamadan önce , hikâyenin kahramanının aslında ben olmadığını fark ettiğim an tüm motivasyonumu kaybettim .	NOUN ADP NOUN VERB DET NOUN VERB PUNCT NOUN PUNCT NOUN VERB PUNCT PRON VERB NOUN VERB NOUN DET NOUN VERB PUNCT
Zaman kavramının gerçek bir yanılsama olduğunu biliyor olsam da , her geçen saniyenin beni hayatın gerçeklerinden daha uzağa taşıdığını hissetmek içimde derin bir boşluk yarattı .	DET NOUN ADJ DET NOUN VERB NOUN VERB CCONJ PUNCT DET ADJ NOUN PRON NOUN NOUN ADV ADJ NOUN VERB PUNCT ADJ DET NOUN VERB PUNCT
Bir satranç maçında her taşın aslında başka birinin hayatını temsil ettiğini düşündüğümde , oyunun galibi olmanın neden beni bu kadar huzursuz ettiğini anladım .	DET NOUN ADJ DET NOUN ADV ADJ DET NOUN NOUN VERB VERB PUNCT NOUN NOUN VERB PUNCT PRON DET ADP ADJ VERB VERB PUNCT
Denizin dalgalarının kıyıya vururken bir melodi oluşturduğunu ve bu melodinin kaybolmuş bir lisanın son kalıntısı olduğunu düşündüm , üzerine uğraşmış olsam da bu melodiyi çözemedim .	AUX PUNCT NOUN VERB DET NOUN VERB CCONJ DET NOUN VERB DET NOUN ADJ NOUN VERB VERB PUNCT NOUN VERB VERB CCONJ DET NOUN VERB PUNCT
Bilgisayarımda rastgele açılan bir pencerede ki yazının , aslında benden başka kimsenin okuyamayacağı bir mesaj olduğunu fark etmek ürkütücü ydü .	ADV ADJ VERB DET NOUN ADP VERB PUNCT ADV ADJ DET NOUN VERB DET NOUN VERB NOUN VERB NOUN VERB PUNCT
Bir radyo programında duyduğum eski bir şiirin sözleri , bana hiç tanımadığım birinin içsel acısını hissettirdi ve bunu anlamlandırmakta zorlandım .	DET NOUN NOUN VERB ADJ DET NOUN VERB PUNCT PRON ADV VERB PUNCT ADV ADJ VERB CCONJ PRON ADV VERB PUNCT
Önce hayatın bana gülümsediğini düşündüm , ama her güzel şeyin bir bede li olduğunu çok geçmeden anladım .	DET NOUN PRON ADV VERB PUNCT CCONJ DET ADJ NOUN DET NOUN ADP VERB ADV ADJ VERB PUNCT
Yolda yürürken yanımdan geçen insanların gülümsemelerinin sahte olduğunu düşündüğüm anda , kendi mutsuzluğumun da onların fark edemeyeceği kadar derinde olduğunu fark ettim .	NOUN VERB PUNCT ADJ NOUN VERB NOUN VERB PUNCT NOUN PUNCT PRON VERB CCONJ DET NOUN VERB ADP ADJ VERB NOUN VERB PUNCT
Eğer o gün eve erken dönmüş olsaydım , belki yağmurdan korunabilirdim ama yine de neyi kaçırmış olurdum diye düşünmeden duramıyoru m	CCONJ DET NOUN NOUN ADV ADJ VERB PUNCT ADV ADJ VERB CCONJ ADV CCONJ DET NOUN VERB ADP VERB PUNCT NOUN
Hayat bazen çok karmaşık ve anlaşılmaz geliyor , ama belki de bu karmaşanın içinde bir düzen var ; yine de bunu bulmak mümkün değil .	NOUN ADV ADV ADJ CCONJ NOUN VERB PUNCT CCONJ ADV CCONJ DET NOUN ADJ DET NOUN VERB PUNCT ADV CCONJ PRON ADV ADJ AUX PUNCT
Bugün parkta otururken gördüğüm küçük çocuğun mutlu kahkahaları bana hayatta umut olduğunu düşündürttü , ta ki yanına gelen yetişkinin onu azarladığı ana kadar .	NOUN NOUN VERB VERB PUNCT NOUN ADJ NOUN PRON NOUN NOUN VERB VERB PUNCT NOUN ADP ADJ VERB PUNCT PRON VERB NOUN ADP PUNCT
Bir dost sohbeti sırasında paylaştığım anılar , beni anlık bir mutluluğa taşımıştı ama onların aslında geri getirilmesi mümkün olmayan kayıplar olduğunu anlamam uzun sürmedi .	DET NOUN NOUN NOUN VERB NOUN PUNCT PRON ADJ DET NOUN VERB CCONJ PRON ADV ADJ VERB ADJ VERB NOUN VERB PUNCT ADJ VERB PUNCT
Bana en son ne zaman dürüst olduğunu düşündüğümde , aklıma hiçbir şey gelmiyor .	PRON ADV ADJ DET NOUN ADJ VERB VERB PUNCT NOUN DET NOUN VERB PUNCT
Seninle bu otobüs yolculuğunu paylaşmak ne kadar keyif li olacak ( ! )	INTJ DET NOUN VERB PUNCT PRON ADP NOUN ADP VERB PUNCT PUNCT PUNCT
Sıcak bir yaz günü tatilin tadını çıkarıyordum , ama aniden gelen fırtına keyfimi tamamen kaçırdı .	ADJ DET NOUN NOUN NOUN NOUN VERB PUNCT CCONJ ADV VERB PUNCT NOUN ADV VERB PUNCT
Radyo dinlerken en sevdiğim şarkının tam ortasında sinyalin kesilmesi , sabah keyfimi tamamen bozdu .	AUX PUNCT ADV VERB PUNCT ADV ADJ NOUN VERB PUNCT NOUN NOUN ADV VERB PUNCT
Gece boyunca uykusuzluğun pençesinde kıvranırken , aklıma gelen tüm hatalarımın aslında ne kadar küçük ama bir o kadar da anlam lı olduğunu hissetmek , uykuya dalmamı imkânsız hale getirdi .	NOUN ADP NOUN NOUN VERB PUNCT NOUN VERB DET NOUN ADV PRON ADP ADJ CCONJ DET NOUN ADP CCONJ NOUN ADP VERB VERB PUNCT NOUN VERB PUNCT NOUN VERB PUNCT
Görmeyi dört gözle beklediğim sergide ki eserlerin çoğunun restorasyonda olduğunu öğrendiğimde hayal kırıklığı yaşadım .	AUX PUNCT NOUN VERB NOUN ADP NOUN NOUN NOUN VERB PUNCT NOUN NOUN VERB PUNCT
Online oyun turnuvasına katıldım , ancak internet bağlantım kesildiği için elimde ki en iyi şansı kaybettim ve turnuvalardan 1 günlüğüne yasak yedim .	DET NOUN NOUN VERB PUNCT CCONJ NOUN NOUN VERB ADP NOUN ADP ADV ADJ NOUN VERB CCONJ NOUN VERB PUNCT NOUN VERB PUNCT
Yeni öğrendiğim programlama dilinde basit bir kod yazmayı denediğimde , hata mesajlarının anlaşılmaz olduğunu fark etmek hevesimi kırdı .	ADJ VERB PUNCT NOUN ADJ DET NOUN VERB VERB PUNCT NOUN NOUN VERB VERB NOUN VERB NOUN VERB PUNCT
Yeni bir makine öğrenmesi projesine başlarken eksik bir veri setiyle karşılaştım , bu da başlangıç aşamasını uzattı .	ADJ DET NOUN VERB PUNCT ADV ADJ DET NOUN NOUN VERB PUNCT PRON CCONJ NOUN NOUN VERB PUNCT
Uzayın sonsuzluğu üzerine düşündüğümde , orada asla bulunamayacağımı bilmek beni bir hayli hayal kırıklığına uğrattı .	AUX PUNCT NOUN VERB PUNCT NOUN ADV VERB PUNCT PRON DET NOUN NOUN NOUN VERB PUNCT
Kolay gelsin lafını dyunca işlerim nasıl kolaylaştı var ya ( ! )	ADJ VERB NOUN VERB NOUN ADV VERB ADJ VERB PUNCT PUNCT PUNCT
Telefonumun kamerası istediğim gibi değil .	NOUN NOUN VERB ADP AUX PUNCT
Bugün yağmur sonrası çıkan gökkuşağı çok güzeldi .	NOUN NOUN NOUN VERB PUNCT ADV VERB PUNCT
Dışarı çıktığımda esen hafif rüzgar beni ferahlattı .	NOUN VERB PUNCT ADJ NOUN PRON VERB PUNCT
Mars ’ tan çekilen fotoğrafları incelerken kızıl gezegenin güzelliği beni büyüledi .	AUX PUNCT NOUN VERB NOUN VERB PUNCT NOUN NOUN PRON VERB PUNCT
Bugün bir drone kullanarak çektiğim manzara videoları harika çıktı .	NOUN DET NOUN VERB PUNCT NOUN NOUN ADJ VERB PUNCT
Dijital sanatla ilgilenen bir sanatçının işlerini gördüm ve çok ilham aldım .	DET NOUN VERB DET NOUN NOUN VERB CCONJ ADV NOUN VERB PUNCT
Yeni keşfettiğim şarkı tam istediğim tonlarda ydı .	ADJ DET NOUN ADV VERB NOUN AUX PUNCT
Bugün alışverişte sevdiğim kıyafeti indirimde buldum .	NOUN NOUN VERB PUNCT NOUN VERB PUNCT
Yurdun bahçesinde otururkken yanıma gelen kedi beni çok eğlendirdi .	AUX PUNCT ADV ADJ VERB PUNCT PRON ADV VERB PUNCT
Akşam yemeğinde annemin yaptığı çorba çok lezzetli ydi .	NOUN NOUN NOUN VERB PUNCT ADV ADJ AUX PUNCT
İnternetten satın aldığım Lego setinin 4 parçası eksikti , neyse ki bana bedavaya yolladılar .	PRON ADV VERB PUNCT NOUN VERB NOUN VERB PUNCT ADV CCONJ PRON NOUN VERB PUNCT
Oynadığım mobil oyunda tamamladığım görevin sistem tarafından sayılmadığını görünce emeklerimin boşa gittiğini düşündüm ama neyse ki uygulamadan gir çık yapınca düzeldi .	AUX PUNCT NOUN VERB PUNCT NOUN NOUN VERB VERB PUNCT NOUN VERB VERB CCONJ NOUN ADP NOUN VERB PUNCT NOUN VERB PUNCT
Uzun süre beklediğim konserin ses sisteminde ki arızalar yüzünden yarıda kesilmesi tam bir hayal kırıklığı ydı ama en azından para iadesi aldık .	ADJ NOUN VERB PUNCT NOUN NOUN ADP NOUN NOUN VERB PUNCT ADJ DET NOUN NOUN VERB CCONJ ADV ADJ NOUN NOUN VERB PUNCT
Bugün bir antik tapınağın sanal turunu yaptım ve sanal turların hiç etkile yici olduğunu düşünmememe rağmen çok ama çok etkilendim ve beğendim .	NOUN DET NOUN VERB PUNCT NOUN VERB CCONJ ADJ NOUN ADV ADJ NOUN VERB VERB ADP ADV CCONJ ADV VERB CCONJ VERB PUNCT
Yolda kaybolduğumu sandım , ama girdiğim sokaklar bana daha önce hiç görmediğim güzellikler sundu .	NOUN VERB VERB PUNCT CCONJ VERB PUNCT PRON ADV ADV ADV VERB NOUN VERB PUNCT
Uzun zaman dır yapamadığım bir iş için kendimi suçlamıştım , ancak sonunda doğru bir zamanda harekete geçmenin daha iyi olduğunu anladım .	ADJ NOUN ADP ADJ DET NOUN ADP PRON VERB PUNCT CCONJ ADV ADJ DET NOUN VERB PUNCT ADV ADJ VERB VERB PUNCT
Hangi yıldızın beni geçmiş bir hayatımdan çağırdığını bilmiyorum , fakat onu her seferinde fark etmeden izlediğimde bir rahatlama hissediyorum .	AUX PUNCT PRON ADJ DET NOUN VERB VERB PUNCT CCONJ PRON DET NOUN NOUN VERB PUNCT DET NOUN VERB PUNCT
Bir dağın zirvesine tırmandığımda hissettiğim yorgunluk , aşağıda ki manzaraya baktığımda tamamen anlamını yitirdi .	DET NOUN NOUN VERB VERB VERB PUNCT NOUN ADP NOUN VERB PUNCT NOUN VERB PUNCT
Eski bir dostla tesadüfi bir karşılaşmanın beni hem şaşırtıp hem de sevindirdiğini anlamam , konuşmanın sonuna doğru mümkün oldu .	ADJ DET NOUN ADJ DET NOUN PRON CCONJ VERB CCONJ CCONJ NOUN VERB PUNCT NOUN VERB ADP ADJ VERB PUNCT
Yağmur altında yürürken hissettiğim huzur , şemsiyem olmamasına rağmen içimde beliren sıcak bir hisle açıklanabilir gibi görünüyor .	ADV ADJ VERB VERB NOUN PUNCT NOUN VERB ADP ADJ VERB ADJ DET NOUN VERB ADP VERB PUNCT
Arkadaşımın hediye ettiği kitap tam da okumak istediğim türde ydi .	DET NOUN VERB NOUN ADV CCONJ VERB VERB NOUN AUX PUNCT
Bu kadar kötü bir gün geçirdiğimi hatırlamıyorum .	DET ADP ADJ DET NOUN VERB VERB PUNCT
Yağmur tüm planlarımı alt üst etti .	INTJ DET NOUN ADV ADJ VERB PUNCT
Onun söyledikleri beni derinden üzdü .	PRON VERB PRON ADJ VERB PUNCT
Her şey giderek daha karmaşık hale geliyor .	DET NOUN VERB ADV ADJ NOUN VERB PUNCT
Bu sessizlik , içimde derin bir boşluk yaratıyor .	DET NOUN PUNCT ADV ADJ DET NOUN VERB PUNCT
Çabalarımın karşılığını bir türlü alamıyorum .	DET NOUN DET ADJ VERB PUNCT
Etrafımda ki insanlar sürekli şikayet ediyor .	NOUN ADP NOUN ADV NOUN VERB PUNCT
Bu kadar kötü bir film izlediğimi hatırlamıyorum .	DET ADP ADJ DET NOUN VERB VERB PUNCT
Yaptığım hataların yükü çok ağır geliyor .	VERB PUNCT NOUN ADV ADJ VERB PUNCT
Her geçen gün işler daha da zorlaşıyor .	DET ADJ NOUN NOUN ADV CCONJ VERB PUNCT
Beni dinlememesi gerçekten kırıcı ydı .	PRON VERB ADV ADJ AUX PUNCT
Sürekli yanlış anlaşılmaktan yoruldum .	ADV ADJ VERB VERB PUNCT
Her şey üst üste geliyor , dayanamıyorum .	DET NOUN ADJ ADJ VERB PUNCT VERB PUNCT
Bütün umutlarım bir anda suya düştü .	ADJ NOUN DET NOUN NOUN VERB PUNCT
Bu kadar adaletsiz bir durum olamaz .	DET ADP ADJ DET NOUN VERB PUNCT
Etrafımda ki insanlar çok bencil davranıyor .	NOUN ADP NOUN ADV ADJ VERB PUNCT
Hayat , bazen katlanılması çok zor hale geliyor .	AUX PUNCT ADV VERB ADV ADJ NOUN VERB PUNCT
Bu soğuk hava beni çok rahatsız ediyor .	DET ADJ NOUN PRON ADV ADJ VERB PUNCT
Her şey tam tersine gidiyor , moralim bozuluyor .	DET NOUN ADV ADJ VERB PUNCT NOUN VERB PUNCT
Bu durum beni oldukça çaresiz hissettiriyor .	DET NOUN PRON ADV ADJ VERB PUNCT
Kendimi ifade edemediğim için üzgünüm .	PRON NOUN VERB ADP VERB PUNCT
Etrafımda ki enerji beni tüketiyor .	NOUN ADP NOUN PRON VERB PUNCT
Her çaba sonuçsuz kalıyor gibi hissediyorum .	DET NOUN ADJ VERB ADP VERB PUNCT
Bu tür eleştiriler moralimi çok bozuyor .	DET NOUN NOUN NOUN ADV VERB PUNCT
Emeğimin karşılığını görememek çok can sıkıcı .	DET NOUN VERB ADV NOUN VERB PUNCT
Yine aynı hataları yapmış olmaktan bıktım .	ADV ADJ NOUN VERB NOUN VERB PUNCT
Her şey daha iyiye gideceğine daha kötüye gidiyor .	DET NOUN ADV ADJ VERB ADV NOUN VERB PUNCT
Bu kadar yalnız hissettiğim bir zaman olmamıştı .	DET ADP ADV VERB DET NOUN VERB PUNCT
Hatalarımın bede li çok ağır oluyor .	NOUN NOUN ADP ADV ADJ VERB PUNCT
Etrafımda ki destek eksikliği beni üzüyor .	NOUN ADP NOUN NOUN PRON VERB PUNCT
Bu kadar olumsuzluk arasında ne yapacağımı bilemiyorum .	DET ADP NOUN ADJ PRON VERB VERB PUNCT
I ̇ nsanların bu kadar anlayışsız olması gerçekten üzücü .	AUX PUNCT NOUN DET ADP ADJ VERB ADV VERB PUNCT
Tüm çabalarım boşa gitmiş gibi hissediyorum .	DET NOUN NOUN VERB ADP VERB PUNCT
Sürekli aynı problemleri yaşamaktan yoruldum .	ADV ADJ NOUN VERB VERB PUNCT
Hayatımda hiçbir şey yolunda gitmiyor .	ADJ DET NOUN NOUN VERB PUNCT
Bu kadar başarısız hissetmek çok yıprat ıcı .	DET ADP ADJ VERB ADV ADJ VERB PUNCT
Kendimi yetersiz hissetmek beni derinden etkiliyor .	PRON ADJ VERB PRON ADJ VERB PUNCT
Bu kadar bir atmosferde motive olmak imkan sız .	DET ADP DET NOUN NOUN VERB NOUN VERB PUNCT
Etrafımda ki insanların ilgisizliği beni çok kırıyor .	NOUN ADP NOUN NOUN PRON ADV VERB PUNCT
Bu kadar kötü bir haber duymayı beklemiyordum .	DET ADP ADJ DET NOUN VERB VERB PUNCT
Sürekli reddedilmek özgüvenimi zedeliyor .	ADV VERB NOUN VERB PUNCT
Tüm uğraşlarıma rağmen bir ilerleme kaydedemiyorum .	DET NOUN ADP DET NOUN VERB PUNCT
Bu karanlık havalar moralimi çok bozuyor .	DET NOUN NOUN NOUN ADV VERB PUNCT
Etrafımda ki gürültü beni fazlasıyla rahatsız ediyor .	NOUN ADP NOUN PRON ADV ADJ VERB PUNCT
Hep aynı sıkıcı döngü içinde yaşıyorum .	ADV ADJ ADJ NOUN ADJ VERB PUNCT
I ̇ nsanların bencilliği beni çok hayal kırıklığına uğratıyor .	AUX PUNCT NOUN NOUN PRON ADV NOUN NOUN VERB PUNCT
Her şey üzerine geliyor gibi hissediyorum .	DET NOUN NOUN VERB ADP VERB PUNCT
Bu kadar stres li olmak fiziksel olarak da etkiliyor .	DET ADP NOUN ADP VERB NOUN ADP CCONJ VERB PUNCT
Hayatın adaletsizliğiyle yüzleşmek çok zor .	NOUN NOUN VERB ADV ADJ PUNCT
Hatalarımın bedelini bu kadar ağır ödemek haksızlık .	NOUN ADJ DET ADP ADJ VERB VERB PUNCT
Etrafımda ki insanların ilgisizliği içimi acıtıyor .	NOUN ADP NOUN NOUN ADJ VERB PUNCT
Her yeni gün aynı sıkıntılarla başlıyor .	DET ADJ NOUN ADJ NOUN VERB PUNCT
Bu kadar kötü bir iş ortamında çalışmak çok zor .	DET ADP ADJ DET NOUN NOUN VERB ADV ADJ PUNCT
Kimse beni anlamıyor gibi hissediyorum .	NOUN PRON VERB ADP VERB PUNCT
Her kararımda yanlış yaptığımı düşünüyorum .	DET NOUN ADJ VERB VERB PUNCT
Bu kadar yalnız hissetmek çok zorla yıcı .	DET ADP ADV VERB ADV VERB VERB PUNCT
Sürekli bir eksiklik hissiyle yaşıyorum .	ADV DET NOUN NOUN VERB PUNCT
Her şey giderek daha kötüye gidiyor .	DET NOUN VERB ADV NOUN VERB PUNCT
Bu kadar büyük bir hayal kırıklığını beklemiyordum .	DET ADP ADJ DET NOUN NOUN VERB PUNCT
Her şey üzerine geliyor gibi hissediyorum .	DET NOUN NOUN VERB ADP VERB PUNCT
Hayatın bu kadar acımasız olabileceğini düşünmemiştim .	INTJ DET ADP ADJ VERB VERB PUNCT
Bir türlü mutluluğu yakalayamıyorum .	DET ADJ NOUN VERB PUNCT
Her şey daha da karmaşık bir hale geliyor .	DET NOUN ADV CCONJ ADJ DET NOUN VERB PUNCT
Kendimi ifade edemediğim için sürekli üzülüyorum .	PRON NOUN VERB ADP ADV VERB PUNCT
I ̇ nsanların bu kadar anlayışsız olması can sıkıcı .	AUX PUNCT NOUN DET ADP ADJ VERB NOUN VERB PUNCT
Her fırsatta bir engel çıkıyor .	DET NOUN DET NOUN VERB PUNCT
Bu kadar yalnız hissettiğim bir dönemde yim .	DET ADP ADV VERB DET NOUN AUX PUNCT
Tüm çabalarım sonuçsuz kalıyor .	DET NOUN ADJ VERB PUNCT
Her şey üst üste gelince ne yapacağımı bilemiyorum .	DET NOUN ADJ ADJ VERB PRON VERB VERB PUNCT
I ̇ nsanların ilgisizliği beni derinden etkiliyor .	AUX PUNCT NOUN NOUN PRON ADJ VERB PUNCT
Kendimi hep yetersiz hissetmek çok üzücü .	PRON ADV ADJ VERB ADV VERB PUNCT
Etrafımda ki sürekli olumsuzluk beni yoruyor .	NOUN ADP ADV NOUN PRON VERB PUNCT
Hatalarımın yükü artık taşınamaz hale geldi .	NOUN NOUN ADV VERB NOUN VERB PUNCT
Sürekli bir şeyler ters gidiyor gibi hissediyorum .	ADV DET NOUN ADJ VERB ADP VERB PUNCT
Bir türlü rahat bir nefes alamıyorum .	DET NOUN ADJ DET NOUN VERB PUNCT
Bu kadar bir ortamda mutlu olmak imkan sız .	DET ADP DET NOUN ADJ VERB NOUN VERB PUNCT
I ̇ nsanların söyledikleri beni derinden yaralıyor .	AUX PUNCT NOUN VERB PRON ADJ VERB PUNCT
Hep aynı döngüde sıkışıp kalmış gibi hissediyorum .	ADV ADJ NOUN VERB VERB ADP VERB PUNCT
Bugün her şey ters gidiyor ve bu kadar kötü bir gün geçirdiğimi hatırlamıyorum .	NOUN DET NOUN ADJ VERB CCONJ DET ADP ADJ DET NOUN VERB VERB PUNCT
Yağmur yağdığı için bütün planlarım alt üst oldu ve dışarı çıkamadım .	NOUN VERB ADP ADJ NOUN ADV ADJ VERB CCONJ NOUN VERB PUNCT
Onun bana söyledikleri beni derinden etkiledi ve çok üzdü .	PRON PRON VERB PRON ADJ VERB CCONJ ADV VERB PUNCT
Hayatım giderek daha karmaşık hale geliyor ve içinden çıkamıyorum .	NOUN VERB ADV ADJ NOUN VERB CCONJ ADJ VERB PUNCT
Bu sessizlik içimde derin bir boşluk yaratıyor ve kendimi yalnız hissediyorum .	DET NOUN ADJ ADJ DET NOUN VERB CCONJ PRON ADV VERB PUNCT
Çabalarımın karşılığını alamamak gerçekten moralimi bozuyor .	DET NOUN VERB ADV NOUN VERB PUNCT
Etrafımda ki insanlar sürekli şikayet ediyor ve bu beni çok rahatsız ediyor .	NOUN ADP NOUN ADV NOUN VERB CCONJ DET PRON ADV ADJ VERB PUNCT
Bu kadar kötü bir film izlediğimi hatırlamıyorum ve zamanımı boşa harcadım .	DET ADP ADJ DET NOUN VERB VERB CCONJ NOUN NOUN VERB PUNCT
Yaptığım hataların yükü çok ağır geliyor ve kendimi suçlu hissediyorum .	VERB PUNCT NOUN ADV ADJ VERB CCONJ PRON ADV VERB PUNCT
Her geçen gün işler daha da zorlaşıyor ve bu durum beni bunaltıyor .	DET ADJ NOUN NOUN ADV CCONJ VERB CCONJ DET NOUN PRON VERB PUNCT
Beni dinlememesi gerçekten çok kırıcı ydı ve üzüldüm .	PRON VERB ADV ADV ADJ AUX CCONJ VERB PUNCT
Sürekli yanlış anlaşılmaktan yoruldum ve ne yapacağımı bilemiyorum .	ADV ADJ VERB VERB CCONJ PRON VERB VERB PUNCT
Her şey üst üste geliyor ve artık dayanamıyorum .	DET NOUN ADJ ADJ VERB CCONJ ADV VERB PUNCT
Bütün umutlarım bir anda suya düştü ve çok hayal kırıklığına uğradım .	ADJ NOUN DET NOUN NOUN VERB CCONJ ADV NOUN NOUN VERB PUNCT
Bu kadar adaletsiz bir durum olamaz ve kendimi çaresiz hissediyorum .	DET ADP ADJ DET NOUN VERB CCONJ PRON ADJ VERB PUNCT
Etrafımda ki insanlar çok bencil davranıyor ve bu durum beni üzüyor .	NOUN ADP NOUN ADV ADJ VERB CCONJ DET NOUN PRON VERB PUNCT
Hayat bazen katlanılması çok zor hale geliyor ve ne yapacağımı bilemiyorum .	NOUN ADV VERB ADV ADJ NOUN VERB CCONJ PRON VERB VERB PUNCT
Bu soğuk hava beni çok rahatsız ediyor ve dışarı çıkmak istemiyorum .	DET ADJ NOUN PRON ADV ADJ VERB CCONJ NOUN VERB VERB PUNCT
Her şey tam tersine gidiyor ve moralim çok bozuluyor .	DET NOUN ADV ADJ VERB CCONJ NOUN ADV VERB PUNCT
Bu durum beni oldukça çaresiz hissettiriyor ve çıkış yolu bulamıyorum .	DET NOUN PRON ADV ADJ VERB CCONJ NOUN NOUN VERB PUNCT
Kendimi ifade edemediğim için çok üzgünüm ve bu durum beni rahatsız ediyor .	PRON NOUN VERB ADP ADV VERB CCONJ DET NOUN PRON ADJ VERB PUNCT
Etrafımda ki enerji beni tüketiyor ve yorgun hissediyorum .	NOUN ADP NOUN PRON VERB CCONJ ADJ VERB PUNCT
Her çaba sonuçsuz kalıyor gibi hissediyorum ve motivasyonumu kaybediyorum .	DET NOUN ADJ VERB ADP VERB CCONJ NOUN VERB PUNCT
Bu tür eleştiriler moralimi çok bozuyor ve kendimi değersiz hissediyorum .	DET NOUN NOUN NOUN ADV VERB CCONJ PRON ADJ VERB PUNCT
Emeğimin karşılığını görememek gerçekten çok can sıkıcı .	DET NOUN VERB ADV ADV NOUN VERB PUNCT
Yine aynı hataları yapmış olmaktan bıktım ve kendime kızıyorum .	ADV ADJ NOUN VERB NOUN VERB CCONJ PRON VERB PUNCT
Her şey daha iyiye gideceğine daha kötüye gidiyor ve bu durum beni üzüyor .	DET NOUN ADV ADJ VERB ADV NOUN VERB CCONJ DET NOUN PRON VERB PUNCT
Bu kadar yalnız hissettiğim bir zaman olmamıştı ve çok üzgünüm .	DET ADP ADV VERB DET NOUN VERB CCONJ ADV VERB PUNCT
Hatalarımın bede li çok ağır oluyor ve bu durum beni yıpratıyor .	NOUN NOUN ADP ADV ADJ VERB CCONJ DET NOUN PRON VERB PUNCT
Etrafımda ki destek eksikliği beni üzüyor ve yalnız hissettiriyor .	NOUN ADP NOUN NOUN PRON VERB CCONJ ADV VERB PUNCT
Bu kadar olumsuzluk arasında ne yapacağımı bilemiyorum ve çaresiz hissediyorum .	DET ADP NOUN ADJ PRON VERB VERB CCONJ ADJ VERB PUNCT
I ̇ nsanların bu kadar anlayışsız olması gerçekten üzücü ve moral bozucu .	AUX PUNCT NOUN DET ADP ADJ VERB ADV ADJ CCONJ NOUN VERB PUNCT
Tüm çabalarım boşa gitmiş gibi hissediyorum ve bu durum beni çok yoruyor .	DET NOUN NOUN VERB ADP VERB CCONJ DET NOUN PRON ADV VERB PUNCT
Sürekli aynı problemleri yaşamaktan yoruldum ve çözüm bulamıyorum .	ADV ADJ NOUN VERB VERB CCONJ NOUN VERB PUNCT
Hayatımda hiçbir şey yolunda gitmiyor ve ne yapacağımı bilemiyorum .	ADJ DET NOUN NOUN VERB CCONJ PRON VERB VERB PUNCT
Bu kadar başarısız hissetmek gerçekten çok yıprat ıcı ve moral bozucu .	DET ADP ADJ VERB ADV ADV VERB PUNCT CCONJ NOUN VERB PUNCT
Kendimi yetersiz hissetmek beni derinden etkiliyor ve özgüvenimi kaybediyorum .	PRON ADJ VERB PRON ADJ VERB CCONJ NOUN VERB PUNCT
Bu kadar bir atmosferde motive olmak gerçekten imkansız .	DET ADP DET NOUN NOUN VERB ADV VERB PUNCT
Etrafımda ki insanların ilgisizliği beni çok kırıyor ve üzgün hissettiriyor .	NOUN ADP NOUN NOUN PRON ADV VERB CCONJ ADJ VERB PUNCT
Bu kadar kötü bir haber duymayı beklemiyordum ve şok oldum .	DET ADP ADJ DET NOUN VERB VERB CCONJ NOUN VERB PUNCT
Sürekli reddedilmek özgüvenimi zedeliyor ve moralimi bozuyor .	ADV VERB NOUN VERB CCONJ NOUN VERB PUNCT
Tüm uğraşlarıma rağmen bir ilerleme kaydedemiyorum ve bu durum beni çok üzüyor .	DET NOUN ADP DET NOUN VERB CCONJ DET NOUN PRON ADV VERB PUNCT
Bu karanlık havalar moralimi çok bozuyor ve içimi karartıyor .	DET NOUN NOUN NOUN ADV VERB CCONJ ADJ VERB PUNCT
Etrafımda ki gürültü beni fazlasıyla rahatsız ediyor ve sinir bozucu .	NOUN ADP NOUN PRON ADV ADJ VERB CCONJ NOUN VERB PUNCT
Hep aynı sıkıcı döngü içinde yaşıyorum ve bu durumdan çok yoruldum .	ADV ADJ ADJ NOUN ADJ VERB CCONJ DET NOUN ADV VERB PUNCT
I ̇ nsanların bencilliği beni çok hayal kırıklığına uğratıyor ve üzgün hissediyorum .	AUX PUNCT NOUN NOUN PRON ADV NOUN NOUN VERB CCONJ ADJ VERB PUNCT
Her şey üzerine geliyor gibi hissediyorum ve bu durum beni çok bunaltıyor .	DET NOUN NOUN VERB ADP VERB CCONJ DET NOUN PRON ADV VERB PUNCT
Bu kadar stres li olmak fiziksel olarak da beni etkiliyor ve sağlığımı bozuyor .	DET ADP NOUN ADP VERB NOUN ADP CCONJ PRON VERB CCONJ NOUN VERB PUNCT
Hayatın adaletsizliğiyle yüzleşmek gerçekten çok zor ve moral bozucu .	NOUN NOUN VERB ADV ADV ADJ CCONJ NOUN VERB PUNCT
Hatalarımın bedelini bu kadar ağır ödemek gerçekten haksızlık .	NOUN ADJ DET ADP ADJ VERB ADV VERB PUNCT
Etrafımda ki insanların ilgisizliği içimi acıtıyor ve yalnız hissettiriyor .	NOUN ADP NOUN NOUN ADJ VERB CCONJ ADV VERB PUNCT
Her yeni gün aynı sıkıntılarla başlıyor ve bu durum beni çok yoruyor .	DET ADJ NOUN ADJ NOUN VERB CCONJ DET NOUN PRON ADV VERB PUNCT
Bu kadar kötü bir iş ortamında çalışmak gerçekten çok zor ve moral bozucu .	DET ADP ADJ DET NOUN NOUN VERB ADV ADV ADJ CCONJ NOUN VERB PUNCT
Kimse beni anlamıyor gibi hissediyorum ve bu durum beni çok üzüyor .	NOUN PRON VERB ADP VERB CCONJ DET NOUN PRON ADV VERB PUNCT
Her kararımda yanlış yaptığımı düşünüyorum ve kendime güvenim kalmadı .	DET NOUN ADJ VERB VERB CCONJ DET NOUN VERB PUNCT
Bu kadar yalnız hissetmek gerçekten çok zorla yıcı ve moral bozucu .	DET ADP ADV VERB ADV ADV VERB PUNCT CCONJ NOUN VERB PUNCT
Sürekli bir eksiklik hissiyle yaşıyorum ve bu durum beni çok üzüyor .	ADV DET NOUN NOUN VERB CCONJ DET NOUN PRON ADV VERB PUNCT
Her şey giderek daha kötüye gidiyor ve bu durum beni çok bunaltıyor .	DET NOUN VERB ADV NOUN VERB CCONJ DET NOUN PRON ADV VERB PUNCT
Bu kadar büyük bir hayal kırıklığını beklemiyordum ve çok üzüldüm .	DET ADP ADJ DET NOUN NOUN VERB CCONJ ADV VERB PUNCT
Her şey üzerine geliyor gibi hissediyorum ve bu durum beni çok bunaltıyor .	DET NOUN NOUN VERB ADP VERB CCONJ DET NOUN PRON ADV VERB PUNCT
Hayatın bu kadar acımasız olabileceğini düşünmemiştim ve şok oldum .	INTJ DET ADP ADJ VERB VERB CCONJ NOUN VERB PUNCT
Bir türlü mutluluğu yakalayamıyorum ve bu durum beni çok üzüyor .	DET ADJ NOUN VERB CCONJ DET NOUN PRON ADV VERB PUNCT
Her şey daha da karmaşık bir hale geliyor ve içinden çıkamıyorum .	DET NOUN ADV CCONJ ADJ DET NOUN VERB CCONJ ADJ VERB PUNCT
Kendimi ifade edemediğim için sürekli üzülüyorum ve bu durum beni rahatsız ediyor .	PRON NOUN VERB ADP ADV VERB CCONJ DET NOUN PRON ADJ VERB PUNCT
I ̇ nsanların bu kadar anlayışsız olması gerçekten çok can sıkıcı .	AUX PUNCT NOUN DET ADP ADJ VERB ADV ADV NOUN VERB PUNCT
Her fırsatta bir engel çıkıyor ve bu durum beni çok üzüyor .	DET NOUN DET NOUN VERB CCONJ DET NOUN PRON ADV VERB PUNCT
Bu kadar yalnız hissettiğim bir dönemde yim ve bu durum beni çok rahatsız ediyor .	DET ADP ADV VERB DET NOUN VERB CCONJ DET NOUN PRON ADV ADJ VERB PUNCT
Tüm çabalarım sonuçsuz kalıyor ve bu durum beni çok üzüyor .	DET NOUN ADJ VERB CCONJ DET NOUN PRON ADV VERB PUNCT
Her şey üst üste gelince ne yapacağımı bilemiyorum ve çaresiz hissediyorum .	DET NOUN ADJ ADJ VERB PRON VERB VERB CCONJ ADJ VERB PUNCT
I ̇ nsanların ilgisizliği beni derinden etkiliyor ve yalnız hissettiriyor .	AUX PUNCT NOUN NOUN PRON ADJ VERB CCONJ ADV VERB PUNCT
Kendimi hep yetersiz hissetmek gerçekten çok üzücü .	PRON ADV ADJ VERB ADV ADV VERB PUNCT
Etrafımda ki sürekli olumsuzluk beni yoruyor ve yıpratıyor .	NOUN ADP ADV NOUN PRON VERB CCONJ VERB PUNCT
Hatalarımın yükü artık taşınamaz hale geldi ve bu durum beni çok üzüyor .	NOUN NOUN ADV VERB NOUN VERB CCONJ DET NOUN PRON ADV VERB PUNCT
Sürekli bir şeyler ters gidiyor gibi hissediyorum ve moralim bozuluyor .	ADV DET NOUN ADJ VERB ADP VERB CCONJ NOUN VERB PUNCT
Bir türlü rahat bir nefes alamıyorum ve bu durum beni çok yoruyor .	DET NOUN ADJ DET NOUN VERB CCONJ DET NOUN PRON ADV VERB PUNCT
Bu kadar bir ortamda mutlu olmak gerçekten imkansız .	DET ADP DET NOUN ADJ VERB ADV VERB PUNCT
I ̇ nsanların söyledikleri beni derinden yaralıyor ve üzüyor .	AUX PUNCT NOUN VERB PRON ADJ VERB CCONJ VERB PUNCT
Hep aynı döngüde sıkışıp kalmış gibi hissediyorum ve çıkış yolu bulamıyorum .	ADV ADJ NOUN VERB VERB ADP VERB CCONJ NOUN NOUN VERB PUNCT
Hatalarım rahatsız edici ve bu durum beni çok üzüyor .	ADV ADJ VERB CCONJ DET NOUN PRON ADV VERB PUNCT
Motivasyon eksikliği beni çok rahatsız ediyor ve iş yapma isteğim kalmıyor .	DET NOUN PRON ADV ADJ VERB CCONJ NOUN VERB NOUN VERB PUNCT
Başarısızlık duygusu beni derinden etkiliyor ve moralimi bozuyor .	DET NOUN PRON ADJ VERB CCONJ NOUN VERB PUNCT
Yalnızlık gerçekten çok zorla yıcı ve bu durum beni çok üzüyor .	PRON ADV ADV VERB PUNCT CCONJ DET NOUN PRON ADV VERB PUNCT
Çabalarım yetersiz kalıyor ve bu durum beni çok üzüyor .	ADV ADJ VERB CCONJ DET NOUN PRON ADV VERB PUNCT
Ruh hali beni tüketiyor ve yorgun hissettiriyor .	AUX PUNCT PRON VERB CCONJ ADJ VERB PUNCT
Hayal kırıklığı beni derinden etkiliyor ve bu durumu atlatmakta zorlanıyorum .	DET NOUN PRON ADJ VERB CCONJ DET NOUN VERB VERB PUNCT
Dışlanmış hissetmek gerçekten çok can sıkıcı ve moral bozucu .	ADV VERB ADV ADV NOUN VERB CCONJ NOUN VERB PUNCT
Zamanımı boşa harcıyor gibi hissediyorum ve bu durum beni çok rahatsız ediyor .	DET NOUN VERB ADP VERB CCONJ DET NOUN PRON ADV ADJ VERB PUNCT
Çıkmazda olmak ve bir çözüm yolu bulamamak gerçekten çok zor .	NOUN VERB CCONJ DET NOUN NOUN VERB ADV ADV ADJ PUNCT
Hayatın zorluğu beni çok yıpratıyor ve enerjimi kaybediyorum .	AUX PUNCT PRON ADV VERB CCONJ NOUN VERB PUNCT
Sorunlar artmaya devam ediyor ve ben ne yapacağımı bilemiyorum .	AUX PUNCT NOUN VERB CCONJ PRON PRON VERB VERB PUNCT
Mücadele etmekten yoruldum ve bu durum beni çok yıpratıyor .	DET NOUN VERB CCONJ DET NOUN PRON ADV VERB PUNCT
Üzücü sonuçlar beni derinden etkiliyor ve moralimi bozuyor .	AUX PUNCT PRON ADJ VERB CCONJ NOUN VERB PUNCT
Kayıplar derin ve bu durum beni çok üzüyor .	ADV ADJ CCONJ DET NOUN PRON ADV VERB PUNCT
Anlaşılmamak gerçekten çok kırıcı ve moral bozucu .	PRON ADV ADV ADJ CCONJ NOUN VERB PUNCT
Olumsuz geri dönüşler almak beni çok üzüyor ve motivasyonumu kaybediyorum .	ADV ADJ NOUN VERB PRON ADV VERB CCONJ NOUN VERB PUNCT
Umutsuzluk duygusu beni derinden etkiliyor ve ne yapacağımı bilemiyorum .	DET NOUN PRON ADJ VERB CCONJ PRON VERB VERB PUNCT
Başarısızlık acıtıyor ve kendimi değersiz hissediyorum .	NOUN VERB CCONJ PRON ADJ VERB PUNCT
Destek eksikliği beni çok yıpratıyor ve yalnız hissettiriyor .	DET NOUN PRON ADV VERB CCONJ ADV VERB PUNCT
Yalnızlık duygusu beni derinden etkiliyor ve moralimi bozuyor .	DET NOUN PRON ADJ VERB CCONJ NOUN VERB PUNCT
Her şeyin üst üste gelmesi beni çok bunaltıyor ve çaresiz hissediyorum .	DET NOUN ADJ ADJ VERB PRON ADV VERB CCONJ ADJ VERB PUNCT
Her şeyin üst üste gelmesi beni çok bunaltıyor ve çaresiz hissediyorum .	DET NOUN ADJ ADJ VERB PRON ADV VERB CCONJ ADJ VERB PUNCT
Sürekli bir şeyler ters gidiyor gibi hissediyorum ve moralim bozuluyor .	ADV DET NOUN ADJ VERB ADP VERB CCONJ NOUN VERB PUNCT
Bu kadar yalnız hissetmek gerçekten çok zorla yıcı ve moral bozucu .	DET ADP ADV VERB ADV ADV VERB PUNCT CCONJ NOUN VERB PUNCT
Hatalarımın bedelini bu kadar ağır ödemek gerçekten haksızlık .	NOUN ADJ DET ADP ADJ VERB ADV VERB PUNCT
Etrafımda ki insanların ilgisizliği içimi acıtıyor ve yalnız hissettiriyor .	NOUN ADP NOUN NOUN ADJ VERB CCONJ ADV VERB PUNCT
Her yeni gün aynı sıkıntılarla başlıyor ve bu durum beni çok yoruyor .	DET ADJ NOUN ADJ NOUN VERB CCONJ DET NOUN PRON ADV VERB PUNCT
Bu kadar kötü bir iş ortamında çalışmak gerçekten çok zor ve moral bozucu .	DET ADP ADJ DET NOUN NOUN VERB ADV ADV ADJ CCONJ NOUN VERB PUNCT
Kimse beni anlamıyor gibi hissediyorum ve bu durum beni çok üzüyor .	NOUN PRON VERB ADP VERB CCONJ DET NOUN PRON ADV VERB PUNCT
Her kararımda yanlış yaptığımı düşünüyorum ve kendime güvenim kalmadı .	DET NOUN ADJ VERB VERB CCONJ DET NOUN VERB PUNCT
Bu kadar yalnız hissetmek gerçekten çok zorla yıcı ve moral bozucu .	DET ADP ADV VERB ADV ADV VERB PUNCT CCONJ NOUN VERB PUNCT
Birlikte çalışmak her zaman daha verimli .	ADP VERB DET NOUN ADV VERB PUNCT
Sabah güneşi insanın içini ısıtıyor .	NOUN NOUN NOUN ADJ VERB PUNCT
Hayallerimiz , geleceği şekillendirir .	AUX PUNCT ADJ VERB PUNCT
Bir dostun omzuna yaslanmak huzur verir .	DET NOUN VERB PUNCT NOUN VERB PUNCT
Etrafında ki güzelliklere odaklan , hayat daha keyif li olur .	NOUN ADP NOUN VERB PUNCT NOUN ADV NOUN ADP VERB PUNCT
Küçük bir tebessüm bile gününü aydınlatabilir .	ADJ DET NOUN ADV NOUN VERB PUNCT
Doğanın sessizliği insana huzur verir .	NOUN NOUN NOUN NOUN VERB PUNCT
Çocukların neşesi , yaşamın en güzel melodisi dir .	ADJ VERB PUNCT NOUN ADV ADJ NOUN AUX PUNCT
Yeni bir yetenek öğrenmek heyecan ver ici .	ADJ DET NOUN VERB NOUN VERB VERB PUNCT
Sevgi , en güçlü bağ dır .	AUX PUNCT ADV ADJ NOUN AUX PUNCT
Bir araya gelince her engeli aşabiliriz .	DET NOUN VERB DET NOUN VERB PUNCT
Mutluluk , paylaşmakla çoğalır .	AUX PUNCT NOUN VERB PUNCT
I ̇ yilik yapmak insanın ruhunu yüceltir .	AUX PUNCT NOUN VERB NOUN NOUN VERB PUNCT
Doğanın renkleri büyüleyici dir .	NOUN NOUN ADJ AUX PUNCT
Şarkı söylemek ruhunu özgürleştirir .	AUX PUNCT NOUN VERB PUNCT
Yeni başlangıçlar her zaman umut dolu dur .	ADJ NOUN DET NOUN NOUN ADJ AUX PUNCT
Bir fincan kahveyle güne güzel başlamak harika .	DET NOUN NOUN NOUN ADJ VERB VERB PUNCT
Sevgi dolu bir aile her şeyden değerli dir .	NOUN ADJ DET NOUN DET NOUN ADJ AUX PUNCT
Birlikte geçirilen zamanlar çok kıymetli dir .	ADP VERB NOUN ADV ADJ AUX PUNCT
Hayallerine inan , her şey mümkün olabilir .	NOUN VERB PUNCT DET NOUN ADJ VERB PUNCT
Doğanın kokusu insana huzur verir .	NOUN NOUN NOUN NOUN VERB PUNCT
Küçük şeylerle mutlu olmayı bilmek harika bir yetenek tir .	ADJ NOUN ADJ VERB PUNCT ADJ DET NOUN AUX PUNCT
Arkadaşlarınla geçirilen keyif li anlar unutulmaz dır .	NOUN VERB NOUN ADP NOUN ADJ AUX PUNCT
Başarı , azim ve inançla gelir .	AUX PUNCT NOUN CCONJ NOUN VERB PUNCT
Güzel bir hikaye insanı derinden etkiler .	ADJ DET NOUN NOUN ADJ VERB PUNCT
Doğanın güzellikleri ruhumuza iyi gelir .	NOUN NOUN NOUN ADJ VERB PUNCT
Güzel bir gün geçirmek tamamen bizim elimizde .	ADJ DET NOUN VERB ADV ADJ VERB PUNCT
Birlik ve beraberlik her zaman güç katar .	PROPN CCONJ ADJ DET NOUN ADJ VERB PUNCT
Kitap okumak , bilgiyle dolu dünyalara açılan bir kapı dır .	NOUN VERB PUNCT NOUN ADJ NOUN VERB DET NOUN AUX PUNCT
Doğanın seslerini dinlemek ruhu dinginleştirir .	NOUN NOUN VERB NOUN VERB PUNCT
Hayatta en güzel şey , sevgi dolu bir kalbe sahip olmak tır .	NOUN ADV ADJ NOUN PUNCT NOUN ADJ DET NOUN NOUN VERB AUX PUNCT
Güneşin doğuşunu izlemek insanı heyecanlandırır .	DET NOUN VERB NOUN VERB PUNCT
Çocukların gülümsemesi dünyayı daha iyi bir yer yapar .	ADJ VERB NOUN ADV ADJ DET NOUN VERB PUNCT
Şükretmek insanı daha huzurlu kılar .	DET NOUN ADV ADJ VERB PUNCT
Yeni yerler keşfetmek hayatı renklendirir .	ADJ NOUN VERB NOUN VERB PUNCT
Sevgiyle büyüyen her şey anlam kazanır .	NOUN VERB DET NOUN NOUN VERB PUNCT
Tatlı bir melodi ruhunu besler .	ADJ DET NOUN NOUN VERB PUNCT
Dostların varlığı en büyük zenginlik tir .	ADJ NOUN ADV ADJ NOUN AUX PUNCT
Her yeni gün , yeni bir umut taşır .	DET ADJ NOUN PUNCT ADJ DET NOUN VERB PUNCT
I ̇ nsanların gülümsemesi , etrafı aydınlatır .	AUX PUNCT NOUN VERB PUNCT NOUN VERB PUNCT
Doğa , bize yaşamın ne kadar güzel olduğunu hatırlatır .	AUX PUNCT PRON NOUN PRON ADP ADJ VERB VERB PUNCT
Her zaman umut etmekten vazgeçme .	DET NOUN NOUN VERB VERB PUNCT
Bir başarıyı paylaşmak , mutluluğu ikiye katlar .	DET NOUN VERB PUNCT NOUN NOUN VERB PUNCT
Samimi bir sohbet insanın ruhunu rahatlatır .	ADJ DET NOUN NOUN NOUN VERB PUNCT
Yaşam , küçük güzellikleri fark ettiğinde daha anlam lı olur .	AUX PUNCT ADJ NOUN NOUN VERB ADV NOUN ADP VERB PUNCT
Hayatta en büyük güç , sevgiyle yapılan işlerde gizli dir .	NOUN ADV ADJ VERB PUNCT NOUN VERB PUNCT ADJ AUX PUNCT
Yağmurun ardından çıkan gökkuşağı umut verir .	DET NOUN VERB PUNCT NOUN VERB PUNCT
Sanat , insanın ruhunu özgürleştirir .	AUX PUNCT NOUN NOUN VERB PUNCT
I ̇ çten bir teşekkür , kalpleri birbirine yaklaştırır .	AUX PUNCT ADJ DET NOUN PUNCT NOUN NOUN VERB PUNCT
Hayata olumlu bakış açısıyla yaklaşmak her şeyi değiştirir .	ADV ADJ NOUN VERB PUNCT DET NOUN VERB PUNCT
Bir çiçeğin açışını izlemek ruhunu dinlendirir .	DET NOUN NOUN VERB NOUN VERB PUNCT
Mutlu bir kahvaltı güne başlamanı sağlar .	ADJ DET NOUN NOUN VERB VERB PUNCT
Küçük başarılar , büyük zaferlerin temeli dir .	ADJ VERB PUNCT ADJ NOUN ADJ AUX PUNCT
Çocukların hayal gücü dünyaya ilham verir .	DET NOUN ADJ NOUN NOUN VERB PUNCT
Her gün yeni bir şey öğrenmek hayatı güzelleştirir .	DET NOUN ADJ DET NOUN VERB NOUN VERB PUNCT
Baharın gelişiyle doğanın uyanışı insanı heyecanlandırır .	DET NOUN NOUN NOUN NOUN VERB PUNCT
Etrafında kilere nazik davranmak her zaman güzeldir .	AUX PUNCT ADV ADJ DET NOUN VERB PUNCT
Güzel bir söz insanın gününü aydınlatabilir .	ADJ DET NOUN NOUN NOUN VERB PUNCT
Doğanın kokusu insana huzur verir .	NOUN NOUN NOUN NOUN VERB PUNCT
Yıldızlı bir gece insana ilham verir .	ADJ DET NOUN NOUN NOUN VERB PUNCT
Mutlu bir yaşam için sevgi en önem li kaynak tır .	ADJ DET NOUN ADP NOUN ADV NOUN ADP ADJ AUX PUNCT
Bir arkadaşın desteği en zor zamanları kolaylaştırır .	DET NOUN NOUN ADV ADJ NOUN VERB PUNCT
Hayatta en değerli şey , sevdiklerinle birlikte olmak tır .	NOUN ADV ADJ NOUN PUNCT NOUN ADP VERB AUX PUNCT
Şarkılar , duygularımızı en iyi ifade etmenin yollarından biri dir .	AUX PUNCT NOUN ADV ADJ NOUN VERB PUNCT PRON AUX PUNCT
Hayat , neşe ve sevgi dolu bir yürekle daha güzeldir .	AUX PUNCT NOUN CCONJ NOUN ADJ DET NOUN ADV VERB PUNCT
Başarı için ilk adım , hayal etmek tir .	NOUN ADP ADJ VERB PUNCT NOUN VERB AUX PUNCT
Her yeni gün , yeni bir şans demek tir .	DET ADJ NOUN PUNCT ADJ DET NOUN VERB AUX PUNCT
Evin sıcaklığı , huzurun en güzel tanımı dır .	NOUN VERB PUNCT NOUN ADV ADJ NOUN AUX PUNCT
Sevdiğin biriyle yapılan yürüyüşler daha anlamlı dır .	DET NOUN VERB PUNCT ADV ADJ AUX PUNCT
Birlikte geçirilen her an , paha biçilemez dir .	ADP VERB DET NOUN PUNCT NOUN VERB AUX PUNCT
Doğa yürüyüşleri insana enerji verir .	NOUN NOUN NOUN NOUN VERB PUNCT
Tatlı bir rüzgar ruhunu canlandırır .	ADJ DET NOUN NOUN VERB PUNCT
Her gün , kendini geliştirmek için bir fırsat tır .	DET NOUN PUNCT PRON VERB ADP DET NOUN AUX PUNCT
Yaşam , sevgi dolu bir yürekle daha anlamlı dır .	AUX PUNCT NOUN ADJ DET NOUN ADV ADJ AUX PUNCT
Başarıya ulaşmak için her zaman bir yol var dır .	NOUN VERB ADP DET NOUN DET NOUN ADJ AUX PUNCT
Yeni bir başlangıç , yeni umutlar getirir .	ADJ DET NOUN PUNCT ADJ NOUN VERB PUNCT
Dostlar , yaşam yolculuğumuzda ki en kıymet li yol arkadaşları dır .	AUX PUNCT NOUN NOUN ADP ADV VERB ADP NOUN NOUN AUX PUNCT
Hayata umutla bakmak her şeyi kolaylaştırır .	DET NOUN VERB DET NOUN VERB PUNCT
Sevdiklerinle birlikte geçirilen anlar unutulmaz dır .	PRON ADP VERB NOUN ADJ AUX PUNCT
Her sabah , yeni bir başlangıcın habercisi dir .	DET NOUN PUNCT ADJ DET NOUN NOUN AUX PUNCT
Yaşam , keşfetmeye değer bir macera dır .	AUX PUNCT ADV ADJ DET NOUN AUX PUNCT
Doğanın güzelliklerini keşfetmek mutluluğu artırır .	NOUN NOUN VERB NOUN VERB PUNCT
Başarı , sabır ve özveriyle gelir .	AUX PUNCT NOUN CCONJ NOUN VERB PUNCT
Her güzel gün , yeni bir hikaye yazar .	DET ADJ NOUN PUNCT ADJ DET NOUN VERB PUNCT
Sevgi dolu bir söz , karanlıkları aydınlatabilir .	NOUN ADJ DET NOUN PUNCT NOUN VERB PUNCT
Güzel anılar biriktirmek hayatı zenginleştirir .	ADJ NOUN VERB NOUN VERB PUNCT
Her yeni gün , bir armağan dır .	DET ADJ NOUN PUNCT DET NOUN AUX PUNCT
Hayal gücü , yaşamın sınırsız olasılıklarını keşfetmek tir .	NOUN VERB PUNCT NOUN ADJ NOUN VERB AUX PUNCT
Şimdiye kadar yaşadığın en güzel gün , bugün dür .	PRON ADP NOUN ADV ADJ NOUN PUNCT NOUN VERB PUNCT
Sevgi dolu bir bakış her şeyi değiştirebilir .	NOUN ADJ DET NOUN DET NOUN VERB PUNCT
Mutluluk , içimizde saklı bir cevher dir .	AUX PUNCT ADV ADJ DET NOUN AUX PUNCT
Şefkat göstermek insanı yüceltir .	AUX PUNCT NOUN VERB PUNCT
Çiçeklerin açışı , doğanın bir mucizesi dir .	NOUN VERB PUNCT ADJ DET NOUN AUX PUNCT
Gülümsemek , kalpleri ısıtır .	VERB PUNCT NOUN VERB PUNCT
Kitaplar , bilginin anahtarı dır .	AUX PUNCT NOUN NOUN AUX PUNCT
Doğanın müziği , ruhumuzu besler .	NOUN VERB PUNCT NOUN VERB PUNCT
Hayata bakmak , her günü güzelleştirir .	NOUN VERB PUNCT DET NOUN VERB PUNCT
Paylaşmak , sevgiyi büyütür .	AUX PUNCT NOUN VERB PUNCT
I ̇ nanç , insanı güçlü kılar .	AUX PUNCT NOUN PUNCT NOUN ADJ VERB PUNCT
Huzurlu bir yürüyüş , ruhunuza iyi gelir .	ADJ DET NOUN PUNCT NOUN ADJ VERB PUNCT
Güne başlamak , başarı getirir .	NOUN VERB PUNCT NOUN VERB PUNCT
Yeni dostluklar , hayatı zenginleştirir .	ADJ VERB PUNCT NOUN VERB PUNCT
Doğa , bize huzur verir .	AUX PUNCT PRON NOUN VERB PUNCT
Hayat , keşfedilmeyi bekleyen bir hazine .	AUX PUNCT NOUN VERB DET NOUN PUNCT
I ̇ yilik yapmak , ruhu besler .	AUX PUNCT NOUN VERB PUNCT NOUN VERB PUNCT
Sevgiyle büyüyen her şey güzelleşir .	NOUN VERB DET NOUN VERB PUNCT
Başarı , sabırla gelir .	AUX PUNCT NOUN VERB PUNCT
Neşeli anılar , ömür boyu kalır .	DET NOUN PUNCT NOUN ADJ VERB PUNCT
Gözyaşları bile bazen iyileştirir .	PRON ADV ADV VERB PUNCT
Düşünmek , hayatı kolaylaştırır .	AUX PUNCT NOUN VERB PUNCT
Sevdiğinle geçirilen zaman , en değerli zaman dır .	ADJ VERB NOUN PUNCT ADV ADJ NOUN AUX PUNCT
Küçük jestler , büyük mutluluklar yaratır .	ADJ VERB PUNCT ADJ NOUN VERB PUNCT
Gülmek , en güzel ilacımız dır .	AUX PUNCT ADV ADJ NOUN AUX PUNCT
Hayaller , geleceği şekillendirir .	AUX PUNCT ADJ VERB PUNCT
Bir dostun yanında olmak , huzur verir .	DET NOUN ADJ VERB PUNCT NOUN VERB PUNCT
Düşünce , hayatı renklendirir .	AUX PUNCT NOUN VERB PUNCT
Güzel bir sabah , harika bir günün habercisi dir .	ADJ DET NOUN PUNCT ADJ DET NOUN NOUN AUX PUNCT
Bir gülüş , dünyayı değiştirir .	DET NOUN PUNCT NOUN VERB PUNCT
Sevgi dolu bir kalp , en güzel hazine dir .	NOUN ADJ DET NOUN PUNCT ADV ADJ NOUN AUX PUNCT
Yeni bir yetenek , heyecan verir .	ADJ DET NOUN PUNCT NOUN VERB PUNCT
Başarı , azimle gelir .	AUX PUNCT NOUN VERB PUNCT
Birlikte olmak , güç katar .	ADP VERB PUNCT ADJ VERB PUNCT
Mutlu bir çocuk , en güzel melodi dir .	ADJ DET NOUN PUNCT ADV ADJ NOUN AUX PUNCT
Doğanın sessizliği , huzur verir .	NOUN VERB PUNCT NOUN VERB PUNCT
Küçük mutluluklar , hayatı güzelleştirir .	ADJ VERB PUNCT NOUN VERB PUNCT
Güneşin doğuşu , yeni umutlar getirir .	NOUN VERB PUNCT ADJ NOUN VERB PUNCT
I ̇ yilik , dünyayı değiştirir .	AUX PUNCT NOUN PUNCT NOUN VERB PUNCT
Sevgi , en güçlü bağ dır .	AUX PUNCT ADV ADJ NOUN AUX PUNCT
Başarı , inançla gelir .	AUX PUNCT NOUN VERB PUNCT
Bir dostun omzunda huzur bulmak , paha biçilmez dir .	DET ADJ DET NOUN VERB PUNCT NOUN VERB AUX PUNCT
Doğa yürüyüşleri , enerjimizi tazeler .	NOUN VERB PUNCT NOUN VERB PUNCT
Şarkılar , ruhumuzu besler .	AUX PUNCT NOUN VERB PUNCT
Mutlu bir an , ömür boyu kalır .	ADJ DET NOUN PUNCT NOUN ADJ VERB PUNCT
Bir çiçeğin açması , mucize dir .	DET NOUN VERB PUNCT NOUN AUX PUNCT
Başarı , emekle gelir .	AUX PUNCT NOUN VERB PUNCT
Güzel bir hikaye , derin izler bırakır .	ADJ DET NOUN PUNCT ADJ NOUN VERB PUNCT
Sevgi dolu bir dokunuş , her şeyi değiştirir .	NOUN ADJ DET NOUN PUNCT DET NOUN VERB PUNCT
Mutlu bir aile , en büyük zenginlik tir .	ADJ DET NOUN PUNCT ADV ADJ NOUN AUX PUNCT
Bakış açısı , hayatı kolaylaştırır .	NOUN VERB PUNCT NOUN VERB PUNCT
Doğanın renkleri , ruhumuzu besler .	NOUN VERB PUNCT NOUN VERB PUNCT
Güne başlamak , her şeyi değiştirir .	NOUN VERB PUNCT DET NOUN VERB PUNCT
Sevgi , en güçlü bağ dır .	AUX PUNCT ADV ADJ NOUN AUX PUNCT
Başarı , sabır ve inançla gelir .	AUX PUNCT NOUN CCONJ NOUN VERB PUNCT
Güzel bir söz , kalpleri ısıtır .	ADJ DET NOUN PUNCT NOUN VERB PUNCT
Yeni yerler keşfetmek , hayatı renklendirir .	ADJ NOUN VERB PUNCT NOUN VERB PUNCT
Bir dostun varlığı , en büyük güç tür .	DET NOUN VERB PUNCT ADV ADJ ADJ AUX PUNCT
Şarkı söylemek , ruhumuzu özgürleştirir .	NOUN VERB PUNCT NOUN VERB PUNCT
Birlikte olmak , her engeli aşar .	ADP VERB PUNCT DET NOUN VERB PUNCT
Mutluluk , paylaşmakla çoğalır .	AUX PUNCT NOUN VERB PUNCT
I ̇ yilik yapmak , ruhu yücel tir .	AUX PUNCT NOUN VERB PUNCT NOUN ADJ AUX PUNCT
Doğanın kokusu , huzur verir .	NOUN VERB PUNCT NOUN VERB PUNCT
Yıldızlı bir gece , ilham verir .	ADJ DET NOUN PUNCT NOUN VERB PUNCT
Sevgi dolu bir yaşam , en güzeli .	NOUN ADJ DET NOUN PUNCT ADV VERB PUNCT
Başarı , azim ve inançla gelir .	AUX PUNCT NOUN CCONJ NOUN VERB PUNCT
Mutlu anılar , ömür boyu kalır .	ADJ VERB PUNCT NOUN ADJ VERB PUNCT
Gülümsemek , kalpleri ısıtır .	VERB PUNCT NOUN VERB PUNCT
Düşünce , hayatı renklendirir .	AUX PUNCT NOUN VERB PUNCT
Yeni dostluklar , hayatı zenginleştirir .	ADJ VERB PUNCT NOUN VERB PUNCT
Bir fincan kahve , güne harika başlar .	DET NOUN VERB PUNCT NOUN ADJ VERB PUNCT
Sevgi dolu bir aile , her şeyden değerli dir .	NOUN ADJ DET NOUN PUNCT DET NOUN ADJ AUX PUNCT
Doğa yürüyüşleri , enerjiyi artırır .	NOUN VERB PUNCT NOUN VERB PUNCT
Tatlı bir melodi , ruhu besler .	ADJ DET NOUN PUNCT NOUN VERB PUNCT
Dostların varlığı , en büyük zenginlik tir .	ADJ VERB PUNCT ADV ADJ NOUN AUX PUNCT
Yeni bir gün , yeni bir umut taşır .	ADJ DET NOUN PUNCT ADJ DET NOUN VERB PUNCT
Gülmek , en güzel ilacımız dır .	AUX PUNCT ADV ADJ NOUN AUX PUNCT
Doğanın güzellikleri , ruhumuzu besler .	NOUN VERB PUNCT NOUN VERB PUNCT
Güzel bir gün geçirmek , tamamen bizim elimizde .	ADJ DET NOUN VERB PUNCT ADV ADJ VERB PUNCT
Birlik ve beraberlik , her zaman güç katar .	PROPN CCONJ VERB PUNCT DET NOUN ADJ VERB PUNCT
Kitap okumak , bilgiye açılan kapı dır .	NOUN VERB PUNCT NOUN VERB NOUN AUX PUNCT
Doğanın seslerini dinlemek , ruhu dinlendirir .	NOUN NOUN VERB PUNCT NOUN VERB PUNCT
Hayatta en güzel şey , sevgi dolu bir kalp tir .	NOUN ADV ADJ NOUN PUNCT NOUN ADJ DET NOUN AUX PUNCT
Güneşin doğuşunu izlemek , heyecanlan dır .	DET NOUN VERB PUNCT NOUN AUX PUNCT
Çocukların gülümsemesi , dünyayı daha iyi yapar .	ADJ VERB PUNCT NOUN ADV ADJ VERB PUNCT
Şükretmek , huzur verir .	AUX PUNCT NOUN VERB PUNCT
Yeni yerler keşfetmek , hayatı renklendirir .	ADJ NOUN VERB PUNCT NOUN VERB PUNCT
Sevgiyle büyüyen her şey , anlam kazanır .	NOUN VERB DET NOUN PUNCT NOUN VERB PUNCT
Dostların varlığı , en büyük zenginlik tir .	ADJ VERB PUNCT ADV ADJ NOUN AUX PUNCT
Her yeni gün , yeni bir umut taşır .	DET ADJ NOUN PUNCT ADJ DET NOUN VERB PUNCT
Doğa , bize yaşamın güzelliğini hatırlatır .	AUX PUNCT PRON NOUN NOUN VERB PUNCT
Gülümsemek , gününü aydınlatır .	VERB PUNCT NOUN VERB PUNCT
Bir dostun yanında olmak , huzur verir .	DET NOUN ADJ VERB PUNCT NOUN VERB PUNCT
Düşünmek , hayatı kolaylaştırır .	AUX PUNCT NOUN VERB PUNCT
Güzel bir sabah , harika bir günün habercisi dir .	ADJ DET NOUN PUNCT ADJ DET NOUN NOUN AUX PUNCT
Bir gülüş , dünyayı değiştirir .	DET NOUN PUNCT NOUN VERB PUNCT
Küçük mutluluklar , hayatı güzelleştirir .	ADJ VERB PUNCT NOUN VERB PUNCT
Güneşin doğuşu , yeni umutlar getirir .	NOUN VERB PUNCT ADJ NOUN VERB PUNCT
I ̇ yilik , dünyayı değiştirir .	AUX PUNCT NOUN PUNCT NOUN VERB PUNCT
Sevgi dolu bir yaşam , en güzel dir .	NOUN ADJ DET NOUN PUNCT ADV ADJ AUX PUNCT
Onu o kadar çok özledim ki haftaya görüşeecek olmamız çok mutluluk ver ici .	PRON DET ADP ADV VERB ADP NOUN VERB PUNCT ADV NOUN VERB VERB PUNCT
Bugün , yapay zeka ile ilgili bir kursa başladım ve çok şey öğrendim .	NOUN PUNCT NOUN VERB CCONJ ADJ DET NOUN VERB CCONJ ADV NOUN VERB PUNCT
VR gözlüğümle oynadığım oyun beni tamamen başka bir dünyaya götürdü .	DET NOUN VERB NOUN PRON ADV ADJ DET NOUN VERB PUNCT
Antik şehirlerle ilgili bir belgesel izlerken hayran kaldım .	DET NOUN ADJ DET NOUN VERB NOUN VERB PUNCT
Oynadığımız orta çağ temalı masaüstü rol yapma oyunu sorunlarımdan uzaklaşmamı sağlıyor .	AUX PUNCT NOUN VERB PUNCT NOUN VERB NOUN NOUN VERB VERB PUNCT
Tatilde çektiğim fotoğraflar çok güzel çıktı .	NOUN VERB PUNCT ADV ADJ VERB PUNCT
ofiste işlerimi hızlıca bitirdim ve kendime vakit ayırdım .	DET NOUN ADV VERB CCONJ DET NOUN VERB PUNCT
Yemeği yakacağımdan korkmuştum ama hiç yanmadı .	DET NOUN VERB CCONJ ADV VERB PUNCT
Dün gece rüyamda güzel bir tatil köyünde olduğumu gördüm .	NOUN NOUN NOUN ADJ DET NOUN NOUN VERB VERB PUNCT
Arkadaşımın hediye ettiği kitap tam da okumak istediğim türde ydi .	DET NOUN VERB NOUN ADV CCONJ VERB VERB NOUN AUX PUNCT
Profesörle paralel evrenlerle alakalı keyif li bir sohbet gerçekleştirdik .	AUX PUNCT NOUN ADJ NOUN ADP DET NOUN VERB PUNCT
Astronotların uzayda nasıl yaşadığını öğrenmek beni çok şaşırttı ve eğlendirdi .	AUX PUNCT ADV VERB PUNCT PRON ADV VERB CCONJ VERB PUNCT
Bir sahaf dükkanında dolaşırken eski bir dergi buldum ve onun sayfalarını karıştırmak çok keyifli ydi .	DET NOUN VERB PUNCT ADJ DET NOUN VERB CCONJ PRON VERB PUNCT ADV ADJ AUX PUNCT
Evde eski bir çekmeceyi karıştırırken çocukluk günlerime ait bir fotoğraf albümü buldum , eski anıları tekrar görmek mutluluk verici ydi .	NOUN ADJ DET NOUN VERB NOUN NOUN ADP DET NOUN NOUN VERB PUNCT ADJ NOUN ADV VERB PUNCT NOUN AUX PUNCT
İşlerimi şaşırtıcı derecede kolaylaştıran bir tarayı cı eklentisi keşfettim .	AUX PUNCT NOUN VERB DET NOUN VERB NOUN VERB PUNCT
Yeni bir dil öğrenmeye başladım ve ilk kelimelerimi düzgün telaffuz edebilmek beni çok heyecanlandırdı , sağlam bir başlangıç yapmış oldum .	ADJ DET NOUN VERB VERB CCONJ ADJ NOUN ADJ VERB PUNCT PRON ADV VERB PUNCT ADJ DET NOUN VERB VERB PUNCT
Bahçeye yeni diktiğim çiçeklerin tomurcuklandığını fark ettim .	ADV ADJ DET NOUN VERB NOUN VERB PUNCT
Gökyüzüne yayılan kuzey ışıkları , evrenin sanatçı ruhunun bir kanıtı ydı .	AUX PUNCT NOUN VERB PUNCT NOUN VERB PUNCT DET NOUN AUX PUNCT
Serginin ortasında duran heykel , hayranlıkla incelenmeyi hak ediyordu .	ADV ADJ VERB VERB PUNCT NOUN VERB NOUN VERB PUNCT
Baharın gelişiyle birlikte parkta açan laleler , renk cümbüşü oluşturdu .	DET NOUN ADP NOUN VERB VERB PUNCT NOUN NOUN VERB PUNCT
Ormanda keşfedilen eski bir kulübe , ihtiyaç halinde ki bir maceracı grubu için sığınak oldu .	AUX PUNCT ADJ DET NOUN PUNCT NOUN NOUN ADP DET NOUN NOUN ADP NOUN VERB PUNCT
Neyse ki kralın kızı akıllı bir insan , bize katılıp babasını tahtından indirmeyi kabul etti .	PRON ADP NOUN ADV ADJ DET NOUN PUNCT PRON VERB PUNCT NOUN VERB NOUN VERB PUNCT
Pagred ' in göz alabildiğince geniş çöllerinde yatan gizemi bulmanın getireceği başarıyı düşünüyorum .	AUX PUNCT NOUN NOUN VERB PUNCT NOUN VERB NOUN VERB PUNCT NOUN VERB PUNCT
Her ne kadar insanlık tarihi boyunca 5 büyük dünya savaşı görmüş olsa da insanoğlu yaklaşık 300 senedir savaş için herhangi bir sebebe sahip değil .	DET NOUN ADP NOUN NOUN ADP ADV ADJ NOUN NOUN VERB VERB CCONJ NOUN VERB PUNCT NOUN NOUN ADP ADJ DET NOUN NOUN AUX PUNCT
Atalarımızın aksine medeniyetimizi daha ileri taşımak adına bu cani eylemi bir kenara bıraktık .	AUX PUNCT NOUN ADV ADJ VERB PUNCT DET NOUN ADJ DET NOUN VERB PUNCT
Tarih tutkusu , özellikle dinler tarihine olan ilgisiyle , Mathias ' ı adeta büyülemişti .	NOUN VERB PUNCT ADV ADJ NOUN VERB VERB PUNCT PROPN PUNCT PRON ADV VERB PUNCT
Yüzünde hafif çizgiler ve yorgunluk izleri olsa da atletik yapısı ve dik duruşu ona güçlü bir duruş kazan dırır .	ADV ADJ VERB CCONJ NOUN NOUN VERB CCONJ ADJ VERB CCONJ ADJ NOUN PRON ADJ DET NOUN ADJ AUX PUNCT
Sol kolunda ve bacağında yer alan protezler , ona olağanüstü bir güç ve hareket kabiliyeti sağlar .	AUX PUNCT CCONJ NOUN NOUN VERB VERB PUNCT PRON ADJ DET NOUN CCONJ NOUN NOUN VERB PUNCT
Ofisin bu katından manzarayı izlemeden ayrılmıyorum .	INTJ DET NOUN NOUN VERB VERB PUNCT
Toplum , yaşlıların bilgeliğine büyük değer verir ve karar alma süreçlerinde onların fikirlerini önceliklendirir .	AUX PUNCT ADJ NOUN ADJ NOUN VERB CCONJ NOUN VERB PUNCT PRON NOUN VERB PUNCT
Elaria , her gece yıldızlara bakar ve onların sırrını çözmeyi arzulardı , bir gün bunu yapabileceğinden habersizdi .	AUX PUNCT DET NOUN NOUN VERB CCONJ PRON ADV ADJ VERB PUNCT DET NOUN PRON ADV VERB PUNCT
Kitapların dünyasında gezinirken , sakin bir içecek eşliğinde , kendi düşüncelerinin arasında bir yolculuğa çıkmak favori aktivitesi .	DET NOUN VERB PUNCT ADJ DET NOUN VERB PUNCT PRON ADV ADJ DET NOUN VERB ADJ VERB PUNCT
İkilinin zıt kişilikleri , onları sadece birer kardeş değil , aynı zamanda en iyi arkadaş yapmıştı .	DET NOUN VERB PUNCT PRON ADV ADJ NOUN AUX PUNCT ADJ NOUN ADV ADJ NOUN VERB PUNCT
Eğitimden çıktıklarında , sadece bilgi ve becerilerle değil , aynı zamanda içlerinde taşıdıkları kararlılık ve sevgiyle de doluydular .	NOUN VERB PUNCT ADV VERB CCONJ NOUN AUX PUNCT ADJ NOUN ADJ VERB PUNCT CCONJ NOUN CCONJ VERB PUNCT
Çalınan eşyaların tümünü sahiplerine ulaştırabildik .	AUX PUNCT NOUN NOUN VERB PUNCT
Hayatımda boyunca verdiğim emeklerim karşılık buluyor artık .	NOUN ADP VERB PUNCT NOUN VERB VERB PUNCT
Günler dir aklımı kurcalayan bulmacayı sonunda çözebildim .	INTJ AUX PUNCT NOUN NOUN ADV VERB PUNCT
Evi temizlemek beni o kadar rahatlattı ki .	AUX PUNCT PRON DET ADP VERB ADP PUNCT
Düğünümüzde uzun süre dir üzerinde çalıştığımız dansı başarıyla gerçekleştirdik .	ADV ADJ NOUN AUX PUNCT NOUN NOUN NOUN VERB PUNCT
Yaşlandıkça güzel anıların yerini kötü anılar alacak sanardım ama haksızmışım .	ADV ADJ DET NOUN ADJ NOUN VERB PUNCT CCONJ VERB PUNCT
Bugün kütüphaneye gelmeden önce bir imza günü olduğunu bilmiyordum , meğerse en sevdiğim yazarlardan biri geliyormuş .	NOUN NOUN VERB ADP DET NOUN NOUN VERB VERB PUNCT PRON ADV VERB PUNCT PRON VERB PUNCT
Her ne kadar abisinin zor bir insan olması sinir bozucu olsa da onun korumacılığını anlayabiliyordu Mathias , ailesi yok ken onu yetiştirdiği için ona minnettardı .	DET NOUN ADP NOUN ADJ DET NOUN VERB PUNCT ADJ VERB CCONJ PRON ADV ADJ VERB PUNCT NOUN ADJ NOUN PRON VERB ADP PRON VERB PUNCT
Kendi yaşamının meydan okumalarıyla büyüdüğünden , öfke duygusunu bir kenara bırakıp yaşamını kabullenmeyi seçti ve aynı hayat kaderini paylaşanlara karşı derin bir empati geliştirdi .	DET NOUN NOUN NOUN VERB PUNCT NOUN ADJ DET NOUN VERB PUNCT NOUN VERB CCONJ ADJ NOUN NOUN NOUN ADP ADJ DET NOUN VERB PUNCT
Biliyorum ki düzgün yönetilirse insanlık bu evrenin görüp görebileceği en gelişmiş toplum olabilir zira özgür irade sadece onlara ait tir .	PRON ADP ADJ VERB PUNCT DET NOUN VERB PUNCT ADV ADJ NOUN VERB PUNCT ADJ NOUN ADV VERB ADP AUX PUNCT
Yağmurlu bir sabahın kasveti üzerime çökmüştü ama bir fincan sıcak kahve ve kedim kötü başlayan günü değiştirdi .	ADJ DET NOUN NOUN NOUN VERB CCONJ DET NOUN ADJ VERB CCONJ NOUN ADJ VERB NOUN VERB PUNCT
Ormanın derinliklerinde , kuşların yankılanan sesiyle büyülenen çınar ağacı , sessizliğin içinde ki melodiyi fark etti ve o an hayatın değerini daha iyi anladı .	NOUN VERB PUNCT NOUN VERB NOUN VERB NOUN VERB PUNCT NOUN VERB ADP NOUN NOUN VERB CCONJ DET NOUN NOUN NOUN ADV ADJ VERB PUNCT
Uzun zaman dır ertelediğim dolap düzenini yaptım ve her şey çok daha derli toplu görünüyor .	ADJ NOUN ADP VERB PUNCT NOUN VERB CCONJ DET NOUN ADV ADV ADJ NOUN VERB PUNCT
Uzun bir süre boyunca bekleyip sabrımın sonuna geldiğimi düşündüğüm anda , tam da istediğim haber geldi .	ADJ DET NOUN ADP VERB PUNCT ADJ VERB PUNCT NOUN PUNCT ADV CCONJ VERB NOUN VERB PUNCT
The Office dizisi Micheal ayrılınca çok kötü olacak diye düşündüm , bir sezonluğuna oldu da fakat Micheal ' ın açtığı boşluğu yan karakterler öyle iyi doldurdu ki final sezonu müthişti .	AUX PUNCT NOUN VERB PUNCT ADV ADJ VERB ADP VERB PUNCT DET NOUN VERB CCONJ NOUN VERB PUNCT NOUN VERB NOUN VERB PUNCT ADV ADJ VERB ADP NOUN NOUN VERB PUNCT
Bugün kü toplantımız çok sessiz gidiyor gibi görünüyordu , bitmesine yakın uzun süre dir konuşmayan Melih ' in aklına gelen fikirle durum tam tersine döndü .	NOUN ADP NOUN ADV ADJ VERB ADP VERB PUNCT PRON ADV ADJ NOUN AUX PUNCT VERB PUNCT NOUN NOUN VERB PUNCT NOUN ADV ADJ VERB PUNCT
Ben , bir zamanlar Amelia olarak anılan , etrafta ışık gibi gezen , kaybolmakla kaybetmek arasında ki farkı hiç bilmeyen ben , artık yolumu bulmuştum .	AUX PUNCT DET NOUN VERB ADP VERB PUNCT NOUN NOUN ADP VERB PUNCT PRON ADV ADJ ADP NOUN ADV ADJ VERB PUNCT ADV ADJ VERB PUNCT
Hep bir gün yaparım dediğim şeyleri nihayet hayata geçirince , o ‘ bir gün ’ ün aslında bugünden çok da farklı olmadığını anlamış oldum .	ADV DET NOUN VERB PUNCT NOUN VERB NOUN VERB PUNCT DET NOUN DET NOUN VERB PUNCT ADV NOUN ADV CCONJ ADJ VERB NOUN VERB PUNCT
Farklı şehirlere taşınınca yollarımız ayrılacak diye üzülüyordum ki , meğer bu ayrılık çok daha güçlü bir bağın başlangı cıymış .	DET NOUN VERB NOUN VERB ADP VERB ADP PUNCT ADJ DET NOUN ADV ADV ADJ DET NOUN NOUN VERB PUNCT
Sıradan bir yürüyüş sırasında rastgele bir köşe sanatçısının yaptığı resim , bana yeni bir hedef kazandırdı , böyle sanat yapmayı öğrenmeli ydim .	ADJ DET NOUN NOUN ADJ DET NOUN NOUN VERB NOUN PUNCT PRON ADJ DET NOUN VERB PUNCT ADV ADJ VERB NOUN VERB PUNCT
Bunu bir daha giymem diye dolaba kaldıracağım ceketin cebinde unuttuğum bir para buldum .	PRON DET NOUN VERB ADP NOUN VERB PUNCT NOUN VERB DET NOUN VERB PUNCT
Tam bir rastlantı sonucu izlemeye başladığım bir belgesel , dünyanın farklı bir yüzünü görmemi sağladı .	INTJ DET NOUN NOUN VERB PUNCT DET NOUN PUNCT NOUN ADJ DET NOUN VERB VERB PUNCT
Yıllar önce yaptığım bir jestin , bugün karşıma çıkacağını tahmin etmezdim .	NOUN ADV VERB DET NOUN PUNCT NOUN NOUN VERB NOUN VERB PUNCT
Önümde incelediğim haritanın köşesinde ki ufak bir sembol , uzun süre dir aradığım hazineyi bulabileceğimi gösteriyor gibi ydi .	ADJ VERB PUNCT NOUN ADP ADJ DET NOUN PUNCT ADJ NOUN AUX PUNCT NOUN VERB VERB ADP AUX PUNCT
Geceyi ağır bir sessizlikle kapatan şehir , sabahın ilk ışıklarıyla yeniden doğan umudu herkese fısıldıyordu .	ADV ADJ DET NOUN VERB VERB PUNCT NOUN ADJ NOUN ADV VERB PUNCT NOUN VERB PUNCT
Paketin içinden sadece sipariş ettiği kitap çıkacağını düşünüyordu ama yanında küçük bir hediye de var dı .	ADV ADJ DET NOUN VERB NOUN VERB VERB CCONJ ADJ ADJ DET NOUN CCONJ ADJ AUX PUNCT
Öksüz ve yetim kalmış olan Sıla , tavan arasında bulduğu kutuda ki mektupların kime ait olduğunu görünce gülümsedi , yüzünde buruk da olsa sıcak bir ifade vardı .	PROPN CCONJ ADJ VERB VERB VERB PUNCT NOUN ADJ DET NOUN ADP NOUN VERB ADP VERB VERB VERB PUNCT NOUN VERB CCONJ ADV ADJ DET NOUN VERB PUNCT
Uzun bir günün ardından eve dönüp kapıyı açtığımda , beni bekleyen o sevim li köpeğin heyecanını görmek , her şeyi unutmamı sağladı .	ADJ DET NOUN NOUN NOUN VERB NOUN VERB PUNCT PRON VERB DET NOUN ADP NOUN NOUN VERB PUNCT DET NOUN VERB VERB PUNCT
Yolun sonuna geldiğimde , aslında yolun orada bitmediğini , yeni bir başlangıç olduğunu fark ettim , hayat da böyle dir zaten .	ADV ADJ VERB PUNCT ADV ADJ NOUN VERB PUNCT ADJ DET NOUN VERB NOUN VERB PUNCT NOUN CCONJ ADJ AUX PUNCT PUNCT
Gece yarısı rüzgarın taşıdığı deniz kokusu , uzak bir kıyıda başlayan ve henüz sonlanmamış bir masalın parçası ydı sanki ve ben bu masalı dinlemek için sabırsızlanıyordum .	AUX PUNCT NOUN VERB NOUN VERB PUNCT ADJ DET NOUN VERB CCONJ ADV ADJ DET NOUN NOUN AUX PUNCT CCONJ PRON DET NOUN VERB ADP VERB PUNCT
Dolabı açtım , peynir kalmamış ama annem ' soğan var , idare et ' dedi ; soğanla tost yaptım , hayatım değişti .	NOUN VERB PUNCT NOUN VERB CCONJ NOUN PUNCT NOUN VERB PUNCT NOUN VERB PUNCT VERB PUNCT NOUN NOUN VERB PUNCT NOUN VERB PUNCT
Bir gün bir sandalyeyle tartıştım ve kazandım ; ertesi gün masa bana meydan okudu , onu da yendim .	DET NOUN DET NOUN VERB CCONJ VERB PUNCT ADJ NOUN NOUN PRON NOUN VERB PUNCT PRON CCONJ VERB PUNCT
Yüz yıl boyunca aktif olmayan makine , Sidney ona dokunduğu anda insan gibi göz kırptı ve konuşmaya başladı ; Sidney o an makinenin yalnızlığını bitirmiş gibi hissetti .	NUM NOUN ADP ADJ VERB VERB PUNCT NOUN PRON VERB NOUN NOUN ADP NOUN VERB CCONJ NOUN VERB PUNCT ADJ DET NOUN NOUN NOUN VERB ADP VERB PUNCT
Kedim televizyonun önünde oturdu , haberleri izler gibi ciddi görünüyordu ; ben de yanına çay koydum , çok tatlı görünüyordu .	DET NOUN ADJ VERB PUNCT NOUN VERB ADP ADJ VERB PUNCT PRON CCONJ ADJ NOUN VERB PUNCT ADV ADJ VERB PUNCT
Ya geçen hafta gidip o yeni kafeyi denedim , aşırı güzeldi , kesin gitmelisin !	CCONJ ADJ NOUN VERB DET ADJ NOUN VERB PUNCT ADJ VERB PUNCT NOUN VERB PUNCT
Gandalf bana bu ışık hüzmesini verdiğinde tereddütlerim vardı yalan olmasın ama madenlerde o kadar işimize yaradı ki eski büyücünün yanına gidip teşekkür etmeliyim .	CCONJ PRON DET NOUN VERB PUNCT NOUN VERB ADJ VERB CCONJ ADJ DET ADP NOUN VERB ADP ADJ NOUN ADJ VERB NOUN VERB PUNCT
Evde ki eski koltuğu boyadım , şimdi baktıkça ona hayat verdiğimi hissediyorum .	NOUN ADP ADJ NOUN VERB PUNCT ADV VERB PUNCT NOUN VERB VERB PUNCT
İnternet gitti diye çok üzüldüm , sonra fark ettim ki elimde ki kitap dünyanın en iyi hikayesini anlatıyormuş .	NOUN VERB ADP ADV VERB PUNCT ADP NOUN VERB ADP NOUN ADP NOUN NOUN ADV ADJ NOUN VERB PUNCT
Ya ofiste biri pasta getirdi , öyle güzel bir şey ki , resmen tatlı cennete gittim geldim .	CCONJ NOUN PRON NOUN VERB PUNCT ADV ADJ DET NOUN ADP PUNCT ADV ADJ NOUN VERB VERB PUNCT
Kütüphanede eski bir kitabı karıştırırken , içinden düşen fotoğraf tam da aradığım ipucu ydu .	ADV ADJ DET NOUN VERB PUNCT ADJ DET NOUN ADV CCONJ ADV ADJ AUX PUNCT
Sanırım şans bana gülümsüyor .	DET NOUN PRON VERB PUNCT
Korkarsan adım almaktan ya da tut ki derinlere dalmaktan , sen korkma yeniden doğar güneş .	DET NOUN VERB CCONJ CCONJ VERB ADP ADJ VERB PUNCT PRON VERB PUNCT NOUN VERB PUNCT
Alışırsın zordur başları , gün olur eden bulur .	DET NOUN VERB PUNCT NOUN VERB NOUN VERB PUNCT
Zamanında beni bağırtarak uyandıran bir kabus görmüştüm , tahmin etmediğim şey ise nasıl bu kabusun beni yazdığım en iyi senaryoya doğru götürmesi ydi .	NOUN PRON ADV ADJ DET NOUN VERB PUNCT NOUN VERB NOUN VERB PUNCT DET NOUN PRON VERB ADV ADJ NOUN ADJ VERB AUX PUNCT
Bu hayatta iyi olduğum bir şey var sa o da satranç tır , çevremden karşıma kim gelirse gelsin yenilmem .	DET NOUN ADJ VERB DET NOUN ADJ AUX PUNCT CCONJ NOUN AUX PUNCT NOUN VERB PUNCT NOUN VERB VERB PUNCT
Sevim üngür hüngür ağlayacak gibi hissederken en iyi arkadaşı olan Hasan onu gülümsetebilecek tek şeyi yaptı , ona sarılmak .	AUX PUNCT NOUN VERB ADP NOUN ADV ADJ NOUN VERB PUNCT PRON ADV ADJ NOUN VERB PUNCT PRON VERB PUNCT
Arcane ' in ikinci sezonunun ilki kadar iyi olacağını düşünmüştüm ama yakınından geçemedi .	AUX PUNCT NOUN ADJ NOUN VERB ADP ADJ ADJ VERB CCONJ ADJ VERB PUNCT
Nerede yse bitireceğimiz savaş tekrar alevlenmiş ve her zaman kinden kötü durumda .	INTJ AUX PUNCT NOUN ADV VERB CCONJ DET NOUN ADP ADJ VERB PUNCT
Anna ve ben bu operasyonu başarıyla tamamlayacağımızı düşündüğümüz için aptal olmalıyız .	PROPN CCONJ PRON DET NOUN NOUN VERB VERB ADP ADJ VERB PUNCT
Küresel yanma sebebiyle dünyada birkaç şehir kalmıştı sadece , bildiğimiz insan medeniyeti çöküşün eşiğinde ydi .	AUX PUNCT NOUN ADJ DET NOUN VERB VERB PUNCT NOUN NOUN VERB PUNCT NOUN AUX PUNCT
Biricik kızım Ireena Kolyana , köyümüzün iyi insanlarının bile onu koruyamayacağı kadar ölümcül bir kötülüğe tutuldu .	AUX PUNCT NOUN VERB PUNCT NOUN ADJ NOUN ADV PRON VERB ADP ADJ DET NOUN VERB PUNCT
Olmayan orduların ile Lordumun kalesini basmaktan çok fazla bahsediyorsun , medet umduğun askerler ise birkaç yeminini bozmuş şövalye , seni asla liderleri olarak görmeyecekler .	AUX PUNCT CCONJ NOUN VERB PUNCT ADV ADJ VERB PUNCT NOUN VERB PUNCT CCONJ DET NOUN VERB VERB PUNCT PRON ADV VERB ADP VERB PUNCT
Bu sene yılbaşı için ne istediği gibi bir hediye alabildi ne de arzuladığı kadar tatil yapabildi .	DET NOUN NOUN ADP PRON VERB ADP DET NOUN VERB PRON CCONJ VERB ADP NOUN VERB PUNCT
İnsanoğlu doğası gereği alıştığı rutinleri bozan olaylar ve kişilerden rahatsız olur .	AUX PUNCT NOUN VERB NOUN VERB PUNCT CCONJ NOUN ADJ VERB PUNCT
Bu gördüğünüz adam büroya ihanetten suçlandı ve ajan olduğu tespit edildi .	DET NOUN NOUN NOUN NOUN VERB CCONJ NOUN VERB NOUN VERB PUNCT
İspanyolca kursuna bu kadar para verdikten sonra öğrenebilmeyi ummuştum .	AUX PUNCT DET ADP NOUN VERB ADP NOUN VERB PUNCT
Fakat bilmenizi isterim ki bu anlaşmanın sebebi kendi kötülüğüm veya güç arzum değildir , sizin bir arkadaş olarak beni yüzüstü bırakmanız ve bu diyarın kaderini etkileyecek olaylarda ki etkinizin minimum olacak olması dır .	DET NOUN VERB ADP DET NOUN NOUN VERB PUNCT ADV ADJ NOUN VERB PUNCT ADJ DET NOUN ADP PRON ADJ VERB CCONJ DET NOUN NOUN VERB NOUN ADP NOUN ADJ VERB VERB AUX PUNCT
Yıllar süren çalışmalar sonucu , çölün rüzgarlarını ve termal akımları kullanarak yükselen hafif hava araçları geliştirdiler ama bu araçlar kurtuluş yerine yok oluş getirdi .	NOUN VERB PUNCT NOUN PUNCT NOUN VERB CCONJ NOUN NOUN VERB PUNCT ADJ NOUN NOUN VERB CCONJ DET NOUN NOUN NOUN ADJ NOUN VERB PUNCT
Oppenheimer atom bombasını geliştirirken icadının bu kadar insanı öldürmek için kullanılacağını düşünmemiş değildi , yine de vicdan azabı çekiyordu .	AUX PUNCT NOUN VERB PUNCT DET ADP NOUN VERB ADP ADV ADJ AUX PUNCT ADV CCONJ NOUN NOUN VERB PUNCT
Sokakta yürürken bir çiçek bana eğilip ' Merhaba ! ' dedi , o an evrende yalnız olmadığımızı hissettim ve bu korkunçtu , galiba deliriyorum .	NOUN VERB DET NOUN PRON VERB PUNCT NOUN VERB PUNCT VERB PUNCT DET NOUN NOUN ADV ADJ VERB CCONJ DET VERB PUNCT ADV VERB PUNCT
Evrenin en uzak köşesinden gelen o sinyal , barış mesajları taşır sanmıştık ama kandırılmışız , işgal edileceğimizden korkuyorum .	PRON ADV ADJ NOUN VERB DET NOUN PUNCT NOUN NOUN VERB PUNCT CCONJ VERB PUNCT NOUN VERB VERB PUNCT
Kırık anılar birden geliyor aklıma , elimde ki kesikler ondan geçmişten yaralar gibi kanıyorlar .	DET NOUN ADV VERB NOUN PUNCT NOUN ADP NOUN VERB PUNCT NOUN ADP VERB PUNCT
Lara ' nın çatışmada aldığı yaraların ciddi olmadığını düşündük , en büyük hatamız bu ydu .	AUX PUNCT NOUN NOUN VERB PUNCT ADJ VERB VERB PUNCT ADV ADJ NOUN PRON AUX PUNCT
Son zamanlarda kendimden bir hayli uzakta duruyorum , olmak istediğim kişi bu değil .	ADJ NOUN ADJ DET NOUN ADJ VERB PUNCT VERB VERB NOUN PRON AUX PUNCT
Mezarıma taş dikmeyin , yaşarken canım çıktı yük taşımaktan .	DET NOUN VERB PUNCT NOUN NOUN VERB NOUN VERB PUNCT
Sıkıştım bir köşeye sanki kendi ruhumda mahçup bir misafir gibi .	INTJ DET NOUN VERB PUNCT NOUN ADJ DET NOUN ADP PUNCT
